AAAAACGCTCGTGATTTGGT -> AAAACGCTCGTGATTTGGTG
AAAAAGGCATGCGCACGCTT -> AAAAGGCATGCGCACGCTTC
AAAACCGGTGAGTAGCGGGT -> AAACCGGTGAGTAGCGGGTG
AAAACGCTCGTGATTTGGTG -> AAACGCTCGTGATTTGGTGT
AAAACTATCTGCTCCCCCAG -> AAACTATCTGCTCCCCCAGC
AAAAGGCATGCGCACGCTTC -> AAAGGCATGCGCACGCTTCA
AAAAGGCTTAAGACCATAAC -> AAAGGCTTAAGACCATAACC
AAAATGCCCGGCCAACCATT -> AAATGCCCGGCCAACCATTC
AAACCGGTGAGTAGCGGGTG -> AACCGGTGAGTAGCGGGTGA
AAACGCTCGTGATTTGGTGT -> AACGCTCGTGATTTGGTGTA
AAACGGTTGTCCCGAACCCG -> AACGGTTGTCCCGAACCCGT
AAACGTGAGATGAAAACCGG -> AACGTGAGATGAAAACCGGT
AAACTATCTGCTCCCCCAGC -> AACTATCTGCTCCCCCAGCA
AAACTCCTCTCCTGAGCCAT -> AACTCCTCTCCTGAGCCATT
AAAGATATAGGGGTAGTGCG -> AAGATATAGGGGTAGTGCGC
AAAGATTCCACACAGTATGC -> AAGATTCCACACAGTATGCT
AAAGGCATGCGCACGCTTCA -> AAGGCATGCGCACGCTTCAA
AAAGGCTTAAGACCATAACC -> AAGGCTTAAGACCATAACCT
AAAGGTTGGCACACCCACAA -> AAGGTTGGCACACCCACAAC
AAATCCTTTGGCCAAATTCC -> AATCCTTTGGCCAAATTCCC
AAATGCCCGGCCAACCATTC -> AATGCCCGGCCAACCATTCC
AAATTCCCACAAGCGTAGGA -> AATTCCCACAAGCGTAGGAG
AACAGGTATCCTTATGGGCC -> ACAGGTATCCTTATGGGCCC
AACCAACAGGTATCCTTATG -> ACCAACAGGTATCCTTATGG
AACCATTCCTTCCCTCATAC -> ACCATTCCTTCCCTCATACC
AACCCGTACAGTCAGCGCTC -> ACCCGTACAGTCAGCGCTCG
AACCGGTGAGTAGCGGGTGA -> ACCGGTGAGTAGCGGGTGAG
AACCTCTGTTATGTTGCTTT -> ACCTCTGTTATGTTGCTTTC
AACCTGCGAATGCTAGAGAT -> ACCTGCGAATGCTAGAGATC
AACGCTCGTGATTTGGTGTA -> ACGCTCGTGATTTGGTGTAC
AACGGTTGTCCCGAACCCGT -> ACGGTTGTCCCGAACCCGTA
AACGTCCTATATGTTGATGA -> ACGTCCTATATGTTGATGAA
AACGTGAGATGAAAACCGGT -> ACGTGAGATGAAAACCGGTG
AACTATCTGCTCCCCCAGCA -> ACTATCTGCTCCCCCAGCAA
AACTCAAACTCCTCTCCTGA -> ACTCAAACTCCTCTCCTGAG
AACTCCTCTCCTGAGCCATT -> ACTCCTCTCCTGAGCCATTA
AACTCGGTGCCCATGTTGGG -> ACTCGGTGCCCATGTTGGGA
AACTCTGCGTGTGGCAGTGC -> ACTCTGCGTGTGGCAGTGCG
AACTGCTCTCAGGCCGCCAA -> ACTGCTCTCAGGCCGCCAAT
AAGACCATAACCTCTGTTAT -> AGACCATAACCTCTGTTATG
AAGATATAGGGGTAGTGCGC -> AGATATAGGGGTAGTGCGCA
AAGATTCCACACAGTATGCT -> AGATTCCACACAGTATGCTG
AAGCATTTTGCCGCACGGTT -> AGCATTTTGCCGCACGGTTC
AAGCCTCCGATGCGAGTTGA -> AGCCTCCGATGCGAGTTGAG
AAGCGTAGGAGGTGGCGGCT -> AGCGTAGGAGGTGGCGGCTG
AAGGCATGCGCACGCTTCAA -> AGGCATGCGCACGCTTCAAA
AAGGCTTAAGACCATAACCT -> AGGCTTAAGACCATAACCTC
AAGGTTGGCACACCCACAAC -> AGGTTGGCACACCCACAACC
AATACCCCGAGTAGGGAAAC -> ATACCCCGAGTAGGGAAACG
AATCCAGGTATGCGACAAAA -> ATCCAGGTATGCGACAAAAG
AATCCTTTGGCCAAATTCCC -> ATCCTTTGGCCAAATTCCCA
AATCGCATGAGTAACTGCTC -> ATCGCATGAGTAACTGCTCT
AATCTGATTTAGGCTGCCCG -> ATCTGATTTAGGCTGCCCGA
AATGCCCGGCCAACCATTCC -> ATGCCCGGCCAACCATTCCT
AATGCTAGAGATCTCTTCTG -> ATGCTAGAGATCTCTTCTGG
AATGGACTCAGGGTGGAGTG -> ATGGACTCAGGGTGGAGTGA
AATGTTGTTCCGTTATTCGA -> ATGTTGTTCCGTTATTCGAA
AATTCCCACAAGCGTAGGAG -> ATTCCCACAAGCGTAGGAGG
AATTGACGAATCCAGGTATG -> ATTGACGAATCCAGGTATGC
ACAAAAGGCTTAAGACCATA -> CAAAAGGCTTAAGACCATAA
ACAACCAACAGGTATCCTTA -> CAACCAACAGGTATCCTTAT
ACAACCTGCGAATGCTAGAG -> CAACCTGCGAATGCTAGAGA
ACAAGCGTAGGAGGTGGCGG -> CAAGCGTAGGAGGTGGCGGC
ACACAACCAACAGGTATCCT -> CACAACCAACAGGTATCCTT
ACACAGTATGCTGTGACGTC -> CACAGTATGCTGTGACGTCA
ACACCCACAACCTGCGAATG -> CACCCACAACCTGCGAATGC
ACACCGGACTGTGGCCTCAG -> CACCGGACTGTGGCCTCAGG
ACACTATTTGAGTCCTGGAA -> CACTATTTGAGTCCTGGAAA
ACACTGCATTAAAGGTTGGC -> CACTGCATTAAAGGTTGGCA
ACAGGTATCCTTATGGGCCC -> CAGGTATCCTTATGGGCCCC
ACAGTATGCTGTGACGTCAG -> CAGTATGCTGTGACGTCAGA
ACAGTCAGCGCTCGACGAGT -> CAGTCAGCGCTCGACGAGTG
ACAGTGTAGAGGATCCACGT -> CAGTGTAGAGGATCCACGTC
ACCAAACGGTTGTCCCGAAC -> CCAAACGGTTGTCCCGAACC
ACCAACAGGTATCCTTATGG -> CCAACAGGTATCCTTATGGG
ACCATAACCTCTGTTATGTT -> CCATAACCTCTGTTATGTTG
ACCATCCCGCAGTTACGGCC -> CCATCCCGCAGTTACGGCCG
ACCATTCCTTCCCTCATACC -> CCATTCCTTCCCTCATACCT
ACCCAAAATGCCCGGCCAAC -> CCCAAAATGCCCGGCCAACC
ACCCACAACCTGCGAATGCT -> CCCACAACCTGCGAATGCTA
ACCCAGGGCCCAACGTCCTA -> CCCAGGGCCCAACGTCCTAT
ACCCCGAGTAGGGAAACGTG -> CCCCGAGTAGGGAAACGTGA
ACCCCTTGTACACAACCAAC -> CCCCTTGTACACAACCAACA
ACCCGTACAGTCAGCGCTCG -> CCCGTACAGTCAGCGCTCGA
ACCGGACTGTGGCCTCAGGA -> CCGGACTGTGGCCTCAGGAG
ACCGGGTTGAATACCCCGAG -> CCGGGTTGAATACCCCGAGT
ACCGGTGAGTAGCGGGTGAG -> CCGGTGAGTAGCGGGTGAGC
ACCTCCGACACCGGACTGTG -> CCTCCGACACCGGACTGTGG
ACCTCTGTTATGTTGCTTTC -> CCTCTGTTATGTTGCTTTCG
ACCTGCGAATGCTAGAGATC -> CCTGCGAATGCTAGAGATCT
ACCTGTTCTACGGAAAAAGG -> CCTGTTCTACGGAAAAAGGC
ACGAATCCAGGTATGCGACA -> CGAATCCAGGTATGCGACAA
ACGAGTGCCATAGTCTGTAG -> CGAGTGCCATAGTCTGTAGC
ACGCAAGCCTCCGATGCGAG -> CGCAAGCCTCCGATGCGAGT
ACGCTCGTGATTTGGTGTAC -> CGCTCGTGATTTGGTGTACC
ACGCTTCAAAGATATAGGGG -> CGCTTCAAAGATATAGGGGT
ACGGAAAAAGGCATGCGCAC -> CGGAAAAAGGCATGCGCACG
ACGGAATGGACTCAGGGTGG -> CGGAATGGACTCAGGGTGGA
ACGGCCGATGGGAAAACTAT -> CGGCCGATGGGAAAACTATC
ACGGTTCAGGAGCCCACGTC -> CGGTTCAGGAGCCCACGTCT
ACGGTTGTCCCGAACCCGTA -> CGGTTGTCCCGAACCCGTAC
ACGTCACGCAAGCCTCCGAT -> CGTCACGCAAGCCTCCGATG
ACGTCAGATTCTTGTGACAC -> CGTCAGATTCTTGTGACACT
ACGTCCTATATGTTGATGAA -> CGTCCTATATGTTGATGAAA
ACGTCTCGAACTCTGCGTGT -> CGTCTCGAACTCTGCGTGTG
ACGTGAGATGAAAACCGGTG -> CGTGAGATGAAAACCGGTGA
ACTATCTGCTCCCCCAGCAA -> CTATCTGCTCCCCCAGCAAA
ACTATTCATCCGTGCGCGTA -> CTATTCATCCGTGCGCGTAC
ACTATTTGAGTCCTGGAAAA -> CTATTTGAGTCCTGGAAAAA
ACTCAAACTCCTCTCCTGAG -> CTCAAACTCCTCTCCTGAGC
ACTCAAGCATTTTGCCGCAC -> CTCAAGCATTTTGCCGCACG
ACTCAGGGTGGAGTGACTGA -> CTCAGGGTGGAGTGACTGAC
ACTCCTCTCCTGAGCCATTA -> CTCCTCTCCTGAGCCATTAT
ACTCCTTTCTTGAACTCAAA -> CTCCTTTCTTGAACTCAAAC
ACTCGGTGCCCATGTTGGGA -> CTCGGTGCCCATGTTGGGAT
ACTCTGCGTGTGGCAGTGCG -> CTCTGCGTGTGGCAGTGCGT
ACTGACAGTGTAGAGGATCC -> CTGACAGTGTAGAGGATCCA
ACTGCATTAAAGGTTGGCAC -> CTGCATTAAAGGTTGGCACA
ACTGCTCTCAGGCCGCCAAT -> CTGCTCTCAGGCCGCCAATT
ACTGTGGCCTCAGGAGAATC -> CTGTGGCCTCAGGAGAATCG
ACTTGCCATAGCCTCTTGTG -> CTTGCCATAGCCTCTTGTGC
AGAATCGCATGAGTAACTGC -> GAATCGCATGAGTAACTGCT
AGACCATAACCTCTGTTATG -> GACCATAACCTCTGTTATGT
AGAGATCTCTTCTGGTGTTG -> GAGATCTCTTCTGGTGTTGA
AGAGGATCCACGTCACGCAA -> GAGGATCCACGTCACGCAAG
AGATATAGGGGTAGTGCGCA -> GATATAGGGGTAGTGCGCAA
AGATCTCTTCTGGTGTTGAG -> GATCTCTTCTGGTGTTGAGG
AGATGAAAACCGGTGAGTAG -> GATGAAAACCGGTGAGTAGC
AGATTCCACACAGTATGCTG -> GATTCCACACAGTATGCTGT
AGATTCTTGTGACACTGCAT -> GATTCTTGTGACACTGCATT
AGATTTCCAGGTGTATTCGG -> GATTTCCAGGTGTATTCGGC
AGCAAAGATTCCACACAGTA -> GCAAAGATTCCACACAGTAT
AGCACCCAGGGCCCAACGTC -> GCACCCAGGGCCCAACGTCC
AGCACTCCTTTCTTGAACTC -> GCACTCCTTTCTTGAACTCA
AGCATTTTGCCGCACGGTTC -> GCATTTTGCCGCACGGTTCA
AGCCATTATGGATAGATTTC -> GCCATTATGGATAGATTTCC
AGCCCACGTCTCGAACTCTG -> GCCCACGTCTCGAACTCTGC
AGCCTCCGATGCGAGTTGAG -> GCCTCCGATGCGAGTTGAGT
AGCCTCTTGTGCGAACTCGG -> GCCTCTTGTGCGAACTCGGT
AGCGCTCGACGAGTGCCATA -> GCGCTCGACGAGTGCCATAG
AGCGGGTGAGCACCCAGGGC -> GCGGGTGAGCACCCAGGGCC
AGCGTAGGAGGTGGCGGCTG -> GCGTAGGAGGTGGCGGCTGA
AGGAGAATCGCATGAGTAAC -> GGAGAATCGCATGAGTAACT
AGGAGCCCACGTCTCGAACT -> GGAGCCCACGTCTCGAACTC
AGGAGGTGGCGGCTGATAGG -> GGAGGTGGCGGCTGATAGGC
AGGATCCACGTCACGCAAGC -> GGATCCACGTCACGCAAGCC
AGGATGGTCGGTTCGGTACA -> GGATGGTCGGTTCGGTACAC
AGGCATGCGCACGCTTCAAA -> GGCATGCGCACGCTTCAAAG
AGGCCAATGTTGTTCCGTTA -> GGCCAATGTTGTTCCGTTAT
AGGCCGCCAATTGACGAATC -> GGCCGCCAATTGACGAATCC
AGGCTGCCCGATGTACCCCT -> GGCTGCCCGATGTACCCCTT
AGGCTTAAGACCATAACCTC -> GGCTTAAGACCATAACCTCT
AGGGAAACGTGAGATGAAAA -> GGGAAACGTGAGATGAAAAC
AGGGCCCAACGTCCTATATG -> GGGCCCAACGTCCTATATGT
AGGGGGGAGTGACCAAACGG -> GGGGGGAGTGACCAAACGGT
AGGGGTAGTGCGCAATCTGA -> GGGGTAGTGCGCAATCTGAT
AGGGTGGAGTGACTGACAGT -> GGGTGGAGTGACTGACAGTG
AGGTATCCTTATGGGCCCCA -> GGTATCCTTATGGGCCCCAC
AGGTATGCGACAAAAGGCTT -> GGTATGCGACAAAAGGCTTA
AGGTGGCGGCTGATAGGCCA -> GGTGGCGGCTGATAGGCCAA
AGGTGTATTCGGCACTTGCC -> GGTGTATTCGGCACTTGCCA
AGGTTGGCACACCCACAACC -> GGTTGGCACACCCACAACCT
AGTAACTGCTCTCAGGCCGC -> GTAACTGCTCTCAGGCCGCC
AGTAGCGGGTGAGCACCCAG -> GTAGCGGGTGAGCACCCAGG
AGTAGGGAAACGTGAGATGA -> GTAGGGAAACGTGAGATGAA
AGTATGCTGTGACGTCAGAT -> GTATGCTGTGACGTCAGATT
AGTCAGCGCTCGACGAGTGC -> GTCAGCGCTCGACGAGTGCC
AGTCCTGGAAAAACGCTCGT -> GTCCTGGAAAAACGCTCGTG
AGTCTGTAGCACTCCTTTCT -> GTCTGTAGCACTCCTTTCTT
AGTGACCAAACGGTTGTCCC -> GTGACCAAACGGTTGTCCCG
AGTGACTGACAGTGTAGAGG -> GTGACTGACAGTGTAGAGGA
AGTGCCATAGTCTGTAGCAC -> GTGCCATAGTCTGTAGCACT
AGTGCGCAATCTGATTTAGG -> GTGCGCAATCTGATTTAGGC
AGTGCGTACCTCCGACACCG -> GTGCGTACCTCCGACACCGG
AGTGTAGAGGATCCACGTCA -> GTGTAGAGGATCCACGTCAC
AGTTACGGCCGATGGGAAAA -> GTTACGGCCGATGGGAAAAC
AGTTACTCAAGCATTTTGCC -> GTTACTCAAGCATTTTGCCG
AGTTGAGTTACTCAAGCATT -> GTTGAGTTACTCAAGCATTT
ATAACCTCTGTTATGTTGCT -> TAACCTCTGTTATGTTGCTT
ATACCCCGAGTAGGGAAACG -> TACCCCGAGTAGGGAAACGT
ATACCTGTTCTACGGAAAAA -> TACCTGTTCTACGGAAAAAG
ATAGATTTCCAGGTGTATTC -> TAGATTTCCAGGTGTATTCG
ATAGCCTCTTGTGCGAACTC -> TAGCCTCTTGTGCGAACTCG
ATAGGCCAATGTTGTTCCGT -> TAGGCCAATGTTGTTCCGTT
ATAGGGGGGAGTGACCAAAC -> TAGGGGGGAGTGACCAAACG
ATAGGGGTAGTGCGCAATCT -> TAGGGGTAGTGCGCAATCTG
ATAGTCTGTAGCACTCCTTT -> TAGTCTGTAGCACTCCTTTC
ATATAGGGGTAGTGCGCAAT -> TATAGGGGTAGTGCGCAATC
ATATGTTGATGAAATCCTTT -> TATGTTGATGAAATCCTTTG
ATCCACGTCACGCAAGCCTC -> TCCACGTCACGCAAGCCTCC
ATCCAGGTATGCGACAAAAG -> TCCAGGTATGCGACAAAAGG
ATCCCGCAGTTACGGCCGAT -> TCCCGCAGTTACGGCCGATG
ATCCGTGCGCGTACCGGGTT -> TCCGTGCGCGTACCGGGTTG
ATCCTTATGGGCCCCACTAT -> TCCTTATGGGCCCCACTATT
ATCCTTTGGCCAAATTCCCA -> TCCTTTGGCCAAATTCCCAC
ATCGCATGAGTAACTGCTCT -> TCGCATGAGTAACTGCTCTC
ATCTCTTCTGGTGTTGAGGA -> TCTCTTCTGGTGTTGAGGAT
ATCTGATTTAGGCTGCCCGA -> TCTGATTTAGGCTGCCCGAT
ATCTGCTCCCCCAGCAAAGA -> TCTGCTCCCCCAGCAAAGAT
ATGAAAACCGGTGAGTAGCG -> TGAAAACCGGTGAGTAGCGG
ATGAAATCCTTTGGCCAAAT -> TGAAATCCTTTGGCCAAATT
ATGAGTAACTGCTCTCAGGC -> TGAGTAACTGCTCTCAGGCC
ATGCCCGGCCAACCATTCCT -> TGCCCGGCCAACCATTCCTT
ATGCGACAAAAGGCTTAAGA -> TGCGACAAAAGGCTTAAGAC
ATGCGAGTTGAGTTACTCAA -> TGCGAGTTGAGTTACTCAAG
ATGCGCACGCTTCAAAGATA -> TGCGCACGCTTCAAAGATAT
ATGCTAGAGATCTCTTCTGG -> TGCTAGAGATCTCTTCTGGT
ATGCTGTGACGTCAGATTCT -> TGCTGTGACGTCAGATTCTT
ATGGACTCAGGGTGGAGTGA -> TGGACTCAGGGTGGAGTGAC
ATGGATAGATTTCCAGGTGT -> TGGATAGATTTCCAGGTGTA
ATGGGAAAACTATCTGCTCC -> TGGGAAAACTATCTGCTCCC
ATGGGCCCCACTATTCATCC -> TGGGCCCCACTATTCATCCG
ATGGTCGGTTCGGTACACTA -> TGGTCGGTTCGGTACACTAT
ATGTACCCCTTGTACACAAC -> TGTACCCCTTGTACACAACC
ATGTTGATGAAATCCTTTGG -> TGTTGATGAAATCCTTTGGC
ATGTTGCTTTCGCGATAGGG -> TGTTGCTTTCGCGATAGGGG
ATGTTGGGATTCCGTTACCA -> TGTTGGGATTCCGTTACCAT
ATGTTGTTCCGTTATTCGAA -> TGTTGTTCCGTTATTCGAAG
ATTAAAGGTTGGCACACCCA -> TTAAAGGTTGGCACACCCAC
ATTATGGATAGATTTCCAGG -> TTATGGATAGATTTCCAGGT
ATTCATCCGTGCGCGTACCG -> TTCATCCGTGCGCGTACCGG
ATTCCACACAGTATGCTGTG -> TTCCACACAGTATGCTGTGA
ATTCCCACAAGCGTAGGAGG -> TTCCCACAAGCGTAGGAGGT
ATTCCGTTACCATCCCGCAG -> TTCCGTTACCATCCCGCAGT
ATTCCTTCCCTCATACCTGT -> TTCCTTCCCTCATACCTGTT
ATTCGGCACTTGCCATAGCC -> TTCGGCACTTGCCATAGCCT
ATTCTTGTGACACTGCATTA -> TTCTTGTGACACTGCATTAA
ATTGACGAATCCAGGTATGC -> TTGACGAATCCAGGTATGCG
ATTTAGGCTGCCCGATGTAC -> TTTAGGCTGCCCGATGTACC
ATTTCCAGGTGTATTCGGCA -> TTTCCAGGTGTATTCGGCAC
ATTTGAGTCCTGGAAAAACG -> TTTGAGTCCTGGAAAAACGC
ATTTGGTGTACCCAAAATGC -> TTTGGTGTACCCAAAATGCC
ATTTTGCCGCACGGTTCAGG -> TTTTGCCGCACGGTTCAGGA
CAAAAGGCTTAAGACCATAA -> AAAAGGCTTAAGACCATAAC
CAAAATGCCCGGCCAACCAT -> AAAATGCCCGGCCAACCATT
CAAACGGTTGTCCCGAACCC -> AAACGGTTGTCCCGAACCCG
CAAACTCCTCTCCTGAGCCA -> AAACTCCTCTCCTGAGCCAT
CAAAGATATAGGGGTAGTGC -> AAAGATATAGGGGTAGTGCG
CAAAGATTCCACACAGTATG -> AAAGATTCCACACAGTATGC
CAAATTCCCACAAGCGTAGG -> AAATTCCCACAAGCGTAGGA
CAACAGGTATCCTTATGGGC -> AACAGGTATCCTTATGGGCC
CAACCAACAGGTATCCTTAT -> AACCAACAGGTATCCTTATG
CAACCATTCCTTCCCTCATA -> AACCATTCCTTCCCTCATAC
CAACCTGCGAATGCTAGAGA -> AACCTGCGAATGCTAGAGAT
CAACGTCCTATATGTTGATG -> AACGTCCTATATGTTGATGA
CAAGCATTTTGCCGCACGGT -> AAGCATTTTGCCGCACGGTT
CAAGCCTCCGATGCGAGTTG -> AAGCCTCCGATGCGAGTTGA
CAAGCGTAGGAGGTGGCGGC -> AAGCGTAGGAGGTGGCGGCT
CAATCTGATTTAGGCTGCCC -> AATCTGATTTAGGCTGCCCG
CAATGTTGTTCCGTTATTCG -> AATGTTGTTCCGTTATTCGA
CAATTGACGAATCCAGGTAT -> AATTGACGAATCCAGGTATG
CACAACCAACAGGTATCCTT -> ACAACCAACAGGTATCCTTA
CACAACCTGCGAATGCTAGA -> ACAACCTGCGAATGCTAGAG
CACAAGCGTAGGAGGTGGCG -> ACAAGCGTAGGAGGTGGCGG
CACACAGTATGCTGTGACGT -> ACACAGTATGCTGTGACGTC
CACACCCACAACCTGCGAAT -> ACACCCACAACCTGCGAATG
CACAGTATGCTGTGACGTCA -> ACAGTATGCTGTGACGTCAG
CACCCACAACCTGCGAATGC -> ACCCACAACCTGCGAATGCT
CACCCAGGGCCCAACGTCCT -> ACCCAGGGCCCAACGTCCTA
CACCGGACTGTGGCCTCAGG -> ACCGGACTGTGGCCTCAGGA
CACGCAAGCCTCCGATGCGA -> ACGCAAGCCTCCGATGCGAG
CACGCTTCAAAGATATAGGG -> ACGCTTCAAAGATATAGGGG
CACGGAATGGACTCAGGGTG -> ACGGAATGGACTCAGGGTGG
CACGGTTCAGGAGCCCACGT -> ACGGTTCAGGAGCCCACGTC
CACGTCACGCAAGCCTCCGA -> ACGTCACGCAAGCCTCCGAT
CACGTCTCGAACTCTGCGTG -> ACGTCTCGAACTCTGCGTGT
CACTATTCATCCGTGCGCGT -> ACTATTCATCCGTGCGCGTA
CACTATTTGAGTCCTGGAAA -> ACTATTTGAGTCCTGGAAAA
CACTCCTTTCTTGAACTCAA -> ACTCCTTTCTTGAACTCAAA
CACTGCATTAAAGGTTGGCA -> ACTGCATTAAAGGTTGGCAC
CACTTGCCATAGCCTCTTGT -> ACTTGCCATAGCCTCTTGTG
CAGATTCTTGTGACACTGCA -> AGATTCTTGTGACACTGCAT
CAGCAAAGATTCCACACAGT -> AGCAAAGATTCCACACAGTA
CAGCGCTCGACGAGTGCCAT -> AGCGCTCGACGAGTGCCATA
CAGGAGAATCGCATGAGTAA -> AGGAGAATCGCATGAGTAAC
CAGGAGCCCACGTCTCGAAC -> AGGAGCCCACGTCTCGAACT
CAGGCCGCCAATTGACGAAT -> AGGCCGCCAATTGACGAATC
CAGGGCCCAACGTCCTATAT -> AGGGCCCAACGTCCTATATG
CAGGGTGGAGTGACTGACAG -> AGGGTGGAGTGACTGACAGT
CAGGTATCCTTATGGGCCCC -> AGGTATCCTTATGGGCCCCA
CAGGTATGCGACAAAAGGCT -> AGGTATGCGACAAAAGGCTT
CAGGTGTATTCGGCACTTGC -> AGGTGTATTCGGCACTTGCC
CAGTATGCTGTGACGTCAGA -> AGTATGCTGTGACGTCAGAT
CAGTCAGCGCTCGACGAGTG -> AGTCAGCGCTCGACGAGTGC
CAGTGCGTACCTCCGACACC -> AGTGCGTACCTCCGACACCG
CAGTGTAGAGGATCCACGTC -> AGTGTAGAGGATCCACGTCA
CAGTTACGGCCGATGGGAAA -> AGTTACGGCCGATGGGAAAA
CATAACCTCTGTTATGTTGC -> ATAACCTCTGTTATGTTGCT
CATACCTGTTCTACGGAAAA -> ATACCTGTTCTACGGAAAAA
CATAGCCTCTTGTGCGAACT -> ATAGCCTCTTGTGCGAACTC
CATAGTCTGTAGCACTCCTT -> ATAGTCTGTAGCACTCCTTT
CATCCCGCAGTTACGGCCGA -> ATCCCGCAGTTACGGCCGAT
CATCCGTGCGCGTACCGGGT -> ATCCGTGCGCGTACCGGGTT
CATGAGTAACTGCTCTCAGG -> ATGAGTAACTGCTCTCAGGC
CATGCGCACGCTTCAAAGAT -> ATGCGCACGCTTCAAAGATA
CATGTTGGGATTCCGTTACC -> ATGTTGGGATTCCGTTACCA
CATTAAAGGTTGGCACACCC -> ATTAAAGGTTGGCACACCCA
CATTATGGATAGATTTCCAG -> ATTATGGATAGATTTCCAGG
CATTCCTTCCCTCATACCTG -> ATTCCTTCCCTCATACCTGT
CATTTTGCCGCACGGTTCAG -> ATTTTGCCGCACGGTTCAGG
CCAAAATGCCCGGCCAACCA -> CAAAATGCCCGGCCAACCAT
CCAAACGGTTGTCCCGAACC -> CAAACGGTTGTCCCGAACCC
CCAAATTCCCACAAGCGTAG -> CAAATTCCCACAAGCGTAGG
CCAACAGGTATCCTTATGGG -> CAACAGGTATCCTTATGGGC
CCAACCATTCCTTCCCTCAT -> CAACCATTCCTTCCCTCATA
CCAACGTCCTATATGTTGAT -> CAACGTCCTATATGTTGATG
CCAATGTTGTTCCGTTATTC -> CAATGTTGTTCCGTTATTCG
CCAATTGACGAATCCAGGTA -> CAATTGACGAATCCAGGTAT
CCACAACCTGCGAATGCTAG -> CACAACCTGCGAATGCTAGA
CCACAAGCGTAGGAGGTGGC -> CACAAGCGTAGGAGGTGGCG
CCACACAGTATGCTGTGACG -> CACACAGTATGCTGTGACGT
CCACGGAATGGACTCAGGGT -> CACGGAATGGACTCAGGGTG
CCACGTCACGCAAGCCTCCG -> CACGTCACGCAAGCCTCCGA
CCACGTCTCGAACTCTGCGT -> CACGTCTCGAACTCTGCGTG
CCACTATTCATCCGTGCGCG -> CACTATTCATCCGTGCGCGT
CCAGCAAAGATTCCACACAG -> CAGCAAAGATTCCACACAGT
CCAGGGCCCAACGTCCTATA -> CAGGGCCCAACGTCCTATAT
CCAGGTATGCGACAAAAGGC -> CAGGTATGCGACAAAAGGCT
CCAGGTGTATTCGGCACTTG -> CAGGTGTATTCGGCACTTGC
CCATAACCTCTGTTATGTTG -> CATAACCTCTGTTATGTTGC
CCATAGCCTCTTGTGCGAAC -> CATAGCCTCTTGTGCGAACT
CCATAGTCTGTAGCACTCCT -> CATAGTCTGTAGCACTCCTT
CCATCCCGCAGTTACGGCCG -> CATCCCGCAGTTACGGCCGA
CCATGTTGGGATTCCGTTAC -> CATGTTGGGATTCCGTTACC
CCATTATGGATAGATTTCCA -> CATTATGGATAGATTTCCAG
CCATTCCTTCCCTCATACCT -> CATTCCTTCCCTCATACCTG
CCCAAAATGCCCGGCCAACC -> CCAAAATGCCCGGCCAACCA
CCCAACGTCCTATATGTTGA -> CCAACGTCCTATATGTTGAT
CCCACAACCTGCGAATGCTA -> CCACAACCTGCGAATGCTAG
CCCACAAGCGTAGGAGGTGG -> CCACAAGCGTAGGAGGTGGC
CCCACGTCTCGAACTCTGCG -> CCACGTCTCGAACTCTGCGT
CCCACTATTCATCCGTGCGC -> CCACTATTCATCCGTGCGCG
CCCAGCAAAGATTCCACACA -> CCAGCAAAGATTCCACACAG
CCCAGGGCCCAACGTCCTAT -> CCAGGGCCCAACGTCCTATA
CCCATGTTGGGATTCCGTTA -> CCATGTTGGGATTCCGTTAC
CCCCACTATTCATCCGTGCG -> CCCACTATTCATCCGTGCGC
CCCCAGCAAAGATTCCACAC -> CCCAGCAAAGATTCCACACA
CCCCCAGCAAAGATTCCACA -> CCCCAGCAAAGATTCCACAC
CCCCGAGTAGGGAAACGTGA -> CCCGAGTAGGGAAACGTGAG
CCCCTTGTACACAACCAACA -> CCCTTGTACACAACCAACAG
CCCGAACCCGTACAGTCAGC -> CCGAACCCGTACAGTCAGCG
CCCGAGTAGGGAAACGTGAG -> CCGAGTAGGGAAACGTGAGA
CCCGATGTACCCCTTGTACA -> CCGATGTACCCCTTGTACAC
CCCGCAGTTACGGCCGATGG -> CCGCAGTTACGGCCGATGGG
CCCGGCCAACCATTCCTTCC -> CCGGCCAACCATTCCTTCCC
CCCGTACAGTCAGCGCTCGA -> CCGTACAGTCAGCGCTCGAC
CCCTCATACCTGTTCTACGG -> CCTCATACCTGTTCTACGGA
CCCTTGTACACAACCAACAG -> CCTTGTACACAACCAACAGG
CCGAACCCGTACAGTCAGCG -> CGAACCCGTACAGTCAGCGC
CCGACACCGGACTGTGGCCT -> CGACACCGGACTGTGGCCTC
CCGAGTAGGGAAACGTGAGA -> CGAGTAGGGAAACGTGAGAT
CCGATGCGAGTTGAGTTACT -> CGATGCGAGTTGAGTTACTC
CCGATGGGAAAACTATCTGC -> CGATGGGAAAACTATCTGCT
CCGATGTACCCCTTGTACAC -> CGATGTACCCCTTGTACACA
CCGCACGGTTCAGGAGCCCA -> CGCACGGTTCAGGAGCCCAC
CCGCAGTTACGGCCGATGGG -> CGCAGTTACGGCCGATGGGA
CCGCCAATTGACGAATCCAG -> CGCCAATTGACGAATCCAGG
CCGGACTGTGGCCTCAGGAG -> CGGACTGTGGCCTCAGGAGA
CCGGCCAACCATTCCTTCCC -> CGGCCAACCATTCCTTCCCT
CCGGGTTGAATACCCCGAGT -> CGGGTTGAATACCCCGAGTA
CCGGTGAGTAGCGGGTGAGC -> CGGTGAGTAGCGGGTGAGCA
CCGTACAGTCAGCGCTCGAC -> CGTACAGTCAGCGCTCGACG
CCGTGCGCGTACCGGGTTGA -> CGTGCGCGTACCGGGTTGAA
CCGTTACCATCCCGCAGTTA -> CGTTACCATCCCGCAGTTAC
CCTATATGTTGATGAAATCC -> CTATATGTTGATGAAATCCT
CCTCAGGAGAATCGCATGAG -> CTCAGGAGAATCGCATGAGT
CCTCATACCTGTTCTACGGA -> CTCATACCTGTTCTACGGAA
CCTCCGACACCGGACTGTGG -> CTCCGACACCGGACTGTGGC
CCTCCGATGCGAGTTGAGTT -> CTCCGATGCGAGTTGAGTTA
CCTCTCCTGAGCCATTATGG -> CTCTCCTGAGCCATTATGGA
CCTCTGTTATGTTGCTTTCG -> CTCTGTTATGTTGCTTTCGC
CCTCTTGTGCGAACTCGGTG -> CTCTTGTGCGAACTCGGTGC
CCTGAGCCATTATGGATAGA -> CTGAGCCATTATGGATAGAT
CCTGCGAATGCTAGAGATCT -> CTGCGAATGCTAGAGATCTC
CCTGGAAAAACGCTCGTGAT -> CTGGAAAAACGCTCGTGATT
CCTGTTCTACGGAAAAAGGC -> CTGTTCTACGGAAAAAGGCA
CCTTATGGGCCCCACTATTC -> CTTATGGGCCCCACTATTCA
CCTTCCCTCATACCTGTTCT -> CTTCCCTCATACCTGTTCTA
CCTTGTACACAACCAACAGG -> CTTGTACACAACCAACAGGT
CCTTTCTTGAACTCAAACTC -> CTTTCTTGAACTCAAACTCC
CCTTTGGCCAAATTCCCACA -> CTTTGGCCAAATTCCCACAA
CGAACCCGTACAGTCAGCGC -> GAACCCGTACAGTCAGCGCT
CGAACTCGGTGCCCATGTTG -> GAACTCGGTGCCCATGTTGG
CGAACTCTGCGTGTGGCAGT -> GAACTCTGCGTGTGGCAGTG
CGAATCCAGGTATGCGACAA -> GAATCCAGGTATGCGACAAA
CGAATGCTAGAGATCTCTTC -> GAATGCTAGAGATCTCTTCT
CGACAAAAGGCTTAAGACCA -> GACAAAAGGCTTAAGACCAT
CGACACCGGACTGTGGCCTC -> GACACCGGACTGTGGCCTCA
CGACGAGTGCCATAGTCTGT -> GACGAGTGCCATAGTCTGTA
CGAGTAGGGAAACGTGAGAT -> GAGTAGGGAAACGTGAGATG
CGAGTGCCATAGTCTGTAGC -> GAGTGCCATAGTCTGTAGCA
CGAGTTGAGTTACTCAAGCA -> GAGTTGAGTTACTCAAGCAT
CGATAGGGGGGAGTGACCAA -> GATAGGGGGGAGTGACCAAA
CGATGCGAGTTGAGTTACTC -> GATGCGAGTTGAGTTACTCA
CGATGGGAAAACTATCTGCT -> GATGGGAAAACTATCTGCTC
CGATGTACCCCTTGTACACA -> GATGTACCCCTTGTACACAA
CGCAAGCCTCCGATGCGAGT -> GCAAGCCTCCGATGCGAGTT
CGCAATCTGATTTAGGCTGC -> GCAATCTGATTTAGGCTGCC
CGCACGCTTCAAAGATATAG -> GCACGCTTCAAAGATATAGG
CGCACGGTTCAGGAGCCCAC -> GCACGGTTCAGGAGCCCACG
CGCAGTTACGGCCGATGGGA -> GCAGTTACGGCCGATGGGAA
CGCATGAGTAACTGCTCTCA -> GCATGAGTAACTGCTCTCAG
CGCCAATTGACGAATCCAGG -> GCCAATTGACGAATCCAGGT
CGCGATAGGGGGGAGTGACC -> GCGATAGGGGGGAGTGACCA
CGCGTACCGGGTTGAATACC -> GCGTACCGGGTTGAATACCC
CGCTCGACGAGTGCCATAGT -> GCTCGACGAGTGCCATAGTC
CGCTCGTGATTTGGTGTACC -> GCTCGTGATTTGGTGTACCC
CGCTTCAAAGATATAGGGGT -> GCTTCAAAGATATAGGGGTA
CGGAAAAAGGCATGCGCACG -> GGAAAAAGGCATGCGCACGC
CGGAATGGACTCAGGGTGGA -> GGAATGGACTCAGGGTGGAG
CGGACTGTGGCCTCAGGAGA -> GGACTGTGGCCTCAGGAGAA
CGGCACTTGCCATAGCCTCT -> GGCACTTGCCATAGCCTCTT
CGGCCAACCATTCCTTCCCT -> GGCCAACCATTCCTTCCCTC
CGGCCGATGGGAAAACTATC -> GGCCGATGGGAAAACTATCT
CGGCTGATAGGCCAATGTTG -> GGCTGATAGGCCAATGTTGT
CGGGTGAGCACCCAGGGCCC -> GGGTGAGCACCCAGGGCCCA
CGGGTTGAATACCCCGAGTA -> GGGTTGAATACCCCGAGTAG
CGGTACACTATTTGAGTCCT -> GGTACACTATTTGAGTCCTG
CGGTGAGTAGCGGGTGAGCA -> GGTGAGTAGCGGGTGAGCAC
CGGTGCCCATGTTGGGATTC -> GGTGCCCATGTTGGGATTCC
CGGTTCAGGAGCCCACGTCT -> GGTTCAGGAGCCCACGTCTC
CGGTTCGGTACACTATTTGA -> GGTTCGGTACACTATTTGAG
CGGTTGTCCCGAACCCGTAC -> GGTTGTCCCGAACCCGTACA
CGTACAGTCAGCGCTCGACG -> GTACAGTCAGCGCTCGACGA
CGTACCGGGTTGAATACCCC -> GTACCGGGTTGAATACCCCG
CGTACCTCCGACACCGGACT -> GTACCTCCGACACCGGACTG
CGTAGGAGGTGGCGGCTGAT -> GTAGGAGGTGGCGGCTGATA
CGTCACGCAAGCCTCCGATG -> GTCACGCAAGCCTCCGATGC
CGTCAGATTCTTGTGACACT -> GTCAGATTCTTGTGACACTG
CGTCCTATATGTTGATGAAA -> GTCCTATATGTTGATGAAAT
CGTCTCGAACTCTGCGTGTG -> GTCTCGAACTCTGCGTGTGG
CGTGAGATGAAAACCGGTGA -> GTGAGATGAAAACCGGTGAG
CGTGATTTGGTGTACCCAAA -> GTGATTTGGTGTACCCAAAA
CGTGCGCGTACCGGGTTGAA -> GTGCGCGTACCGGGTTGAAT
CGTGTGGCAGTGCGTACCTC -> GTGTGGCAGTGCGTACCTCC
CGTTACCATCCCGCAGTTAC -> GTTACCATCCCGCAGTTACG
CTACGGAAAAAGGCATGCGC -> TACGGAAAAAGGCATGCGCA
CTAGAGATCTCTTCTGGTGT -> TAGAGATCTCTTCTGGTGTT
CTATATGTTGATGAAATCCT -> TATATGTTGATGAAATCCTT
CTATCTGCTCCCCCAGCAAA -> TATCTGCTCCCCCAGCAAAG
CTATTCATCCGTGCGCGTAC -> TATTCATCCGTGCGCGTACC
CTATTTGAGTCCTGGAAAAA -> TATTTGAGTCCTGGAAAAAC
CTCAAACTCCTCTCCTGAGC -> TCAAACTCCTCTCCTGAGCC
CTCAAGCATTTTGCCGCACG -> TCAAGCATTTTGCCGCACGG
CTCAGGAGAATCGCATGAGT -> TCAGGAGAATCGCATGAGTA
CTCAGGCCGCCAATTGACGA -> TCAGGCCGCCAATTGACGAA
CTCAGGGTGGAGTGACTGAC -> TCAGGGTGGAGTGACTGACA
CTCATACCTGTTCTACGGAA -> TCATACCTGTTCTACGGAAA
CTCCCCCAGCAAAGATTCCA -> TCCCCCAGCAAAGATTCCAC
CTCCGACACCGGACTGTGGC -> TCCGACACCGGACTGTGGCC
CTCCGATGCGAGTTGAGTTA -> TCCGATGCGAGTTGAGTTAC
CTCCTCTCCTGAGCCATTAT -> TCCTCTCCTGAGCCATTATG
CTCCTGAGCCATTATGGATA -> TCCTGAGCCATTATGGATAG
CTCCTTTCTTGAACTCAAAC -> TCCTTTCTTGAACTCAAACT
CTCGAACTCTGCGTGTGGCA -> TCGAACTCTGCGTGTGGCAG
CTCGACGAGTGCCATAGTCT -> TCGACGAGTGCCATAGTCTG
CTCGGTGCCCATGTTGGGAT -> TCGGTGCCCATGTTGGGATT
CTCGTGATTTGGTGTACCCA -> TCGTGATTTGGTGTACCCAA
CTCTCAGGCCGCCAATTGAC -> TCTCAGGCCGCCAATTGACG
CTCTCCTGAGCCATTATGGA -> TCTCCTGAGCCATTATGGAT
CTCTGCGTGTGGCAGTGCGT -> TCTGCGTGTGGCAGTGCGTA
CTCTGTTATGTTGCTTTCGC -> TCTGTTATGTTGCTTTCGCG
CTCTTCTGGTGTTGAGGATG -> TCTTCTGGTGTTGAGGATGG
CTCTTGTGCGAACTCGGTGC -> TCTTGTGCGAACTCGGTGCC
CTGACAGTGTAGAGGATCCA -> TGACAGTGTAGAGGATCCAC
CTGAGCCATTATGGATAGAT -> TGAGCCATTATGGATAGATT
CTGATAGGCCAATGTTGTTC -> TGATAGGCCAATGTTGTTCC
CTGATTTAGGCTGCCCGATG -> TGATTTAGGCTGCCCGATGT
CTGCATTAAAGGTTGGCACA -> TGCATTAAAGGTTGGCACAC
CTGCCCGATGTACCCCTTGT -> TGCCCGATGTACCCCTTGTA
CTGCGAATGCTAGAGATCTC -> TGCGAATGCTAGAGATCTCT
CTGCGTGTGGCAGTGCGTAC -> TGCGTGTGGCAGTGCGTACC
CTGCTCCCCCAGCAAAGATT -> TGCTCCCCCAGCAAAGATTC
CTGCTCTCAGGCCGCCAATT -> TGCTCTCAGGCCGCCAATTG
CTGGAAAAACGCTCGTGATT -> TGGAAAAACGCTCGTGATTT
CTGGTGTTGAGGATGGTCGG -> TGGTGTTGAGGATGGTCGGT
CTGTAGCACTCCTTTCTTGA -> TGTAGCACTCCTTTCTTGAA
CTGTGACGTCAGATTCTTGT -> TGTGACGTCAGATTCTTGTG
CTGTGGCCTCAGGAGAATCG -> TGTGGCCTCAGGAGAATCGC
CTGTTATGTTGCTTTCGCGA -> TGTTATGTTGCTTTCGCGAT
CTGTTCTACGGAAAAAGGCA -> TGTTCTACGGAAAAAGGCAT
CTTAAGACCATAACCTCTGT -> TTAAGACCATAACCTCTGTT
CTTATGGGCCCCACTATTCA -> TTATGGGCCCCACTATTCAT
CTTCAAAGATATAGGGGTAG -> TTCAAAGATATAGGGGTAGT
CTTCCCTCATACCTGTTCTA -> TTCCCTCATACCTGTTCTAC
CTTCTGGTGTTGAGGATGGT -> TTCTGGTGTTGAGGATGGTC
CTTGAACTCAAACTCCTCTC -> TTGAACTCAAACTCCTCTCC
CTTGCCATAGCCTCTTGTGC -> TTGCCATAGCCTCTTGTGCG
CTTGTACACAACCAACAGGT -> TTGTACACAACCAACAGGTA
CTTGTGACACTGCATTAAAG -> TTGTGACACTGCATTAAAGG
CTTGTGCGAACTCGGTGCCC -> TTGTGCGAACTCGGTGCCCA
CTTTCGCGATAGGGGGGAGT -> TTTCGCGATAGGGGGGAGTG
CTTTCTTGAACTCAAACTCC -> TTTCTTGAACTCAAACTCCT
CTTTGGCCAAATTCCCACAA -> TTTGGCCAAATTCCCACAAG
GAAAAACGCTCGTGATTTGG -> AAAAACGCTCGTGATTTGGT
GAAAAAGGCATGCGCACGCT -> AAAAAGGCATGCGCACGCTT
GAAAACCGGTGAGTAGCGGG -> AAAACCGGTGAGTAGCGGGT
GAAAACTATCTGCTCCCCCA -> AAAACTATCTGCTCCCCCAG
GAAACGTGAGATGAAAACCG -> AAACGTGAGATGAAAACCGG
GAAATCCTTTGGCCAAATTC -> AAATCCTTTGGCCAAATTCC
GAACCCGTACAGTCAGCGCT -> AACCCGTACAGTCAGCGCTC
GAACTCAAACTCCTCTCCTG -> AACTCAAACTCCTCTCCTGA
GAACTCGGTGCCCATGTTGG -> AACTCGGTGCCCATGTTGGG
GAACTCTGCGTGTGGCAGTG -> AACTCTGCGTGTGGCAGTGC
GAATACCCCGAGTAGGGAAA -> AATACCCCGAGTAGGGAAAC
GAATCCAGGTATGCGACAAA -> AATCCAGGTATGCGACAAAA
GAATCGCATGAGTAACTGCT -> AATCGCATGAGTAACTGCTC
GAATGCTAGAGATCTCTTCT -> AATGCTAGAGATCTCTTCTG
GAATGGACTCAGGGTGGAGT -> AATGGACTCAGGGTGGAGTG
GACAAAAGGCTTAAGACCAT -> ACAAAAGGCTTAAGACCATA
GACACCGGACTGTGGCCTCA -> ACACCGGACTGTGGCCTCAG
GACACTGCATTAAAGGTTGG -> ACACTGCATTAAAGGTTGGC
GACAGTGTAGAGGATCCACG -> ACAGTGTAGAGGATCCACGT
GACCAAACGGTTGTCCCGAA -> ACCAAACGGTTGTCCCGAAC
GACCATAACCTCTGTTATGT -> ACCATAACCTCTGTTATGTT
GACGAATCCAGGTATGCGAC -> ACGAATCCAGGTATGCGACA
GACGAGTGCCATAGTCTGTA -> ACGAGTGCCATAGTCTGTAG
GACGTCAGATTCTTGTGACA -> ACGTCAGATTCTTGTGACAC
GACTCAGGGTGGAGTGACTG -> ACTCAGGGTGGAGTGACTGA
GACTGACAGTGTAGAGGATC -> ACTGACAGTGTAGAGGATCC
GACTGTGGCCTCAGGAGAAT -> ACTGTGGCCTCAGGAGAATC
GAGAATCGCATGAGTAACTG -> AGAATCGCATGAGTAACTGC
GAGATCTCTTCTGGTGTTGA -> AGATCTCTTCTGGTGTTGAG
GAGATGAAAACCGGTGAGTA -> AGATGAAAACCGGTGAGTAG
GAGCACCCAGGGCCCAACGT -> AGCACCCAGGGCCCAACGTC
GAGCCATTATGGATAGATTT -> AGCCATTATGGATAGATTTC
GAGCCCACGTCTCGAACTCT -> AGCCCACGTCTCGAACTCTG
GAGGATCCACGTCACGCAAG -> AGGATCCACGTCACGCAAGC
GAGGATGGTCGGTTCGGTAC -> AGGATGGTCGGTTCGGTACA
GAGGTGGCGGCTGATAGGCC -> AGGTGGCGGCTGATAGGCCA
GAGTAACTGCTCTCAGGCCG -> AGTAACTGCTCTCAGGCCGC
GAGTAGCGGGTGAGCACCCA -> AGTAGCGGGTGAGCACCCAG
GAGTAGGGAAACGTGAGATG -> AGTAGGGAAACGTGAGATGA
GAGTCCTGGAAAAACGCTCG -> AGTCCTGGAAAAACGCTCGT
GAGTGACCAAACGGTTGTCC -> AGTGACCAAACGGTTGTCCC
GAGTGACTGACAGTGTAGAG -> AGTGACTGACAGTGTAGAGG
GAGTGCCATAGTCTGTAGCA -> AGTGCCATAGTCTGTAGCAC
GAGTTACTCAAGCATTTTGC -> AGTTACTCAAGCATTTTGCC
GAGTTGAGTTACTCAAGCAT -> AGTTGAGTTACTCAAGCATT
GATAGATTTCCAGGTGTATT -> ATAGATTTCCAGGTGTATTC
GATAGGCCAATGTTGTTCCG -> ATAGGCCAATGTTGTTCCGT
GATAGGGGGGAGTGACCAAA -> ATAGGGGGGAGTGACCAAAC
GATATAGGGGTAGTGCGCAA -> ATATAGGGGTAGTGCGCAAT
GATCCACGTCACGCAAGCCT -> ATCCACGTCACGCAAGCCTC
GATCTCTTCTGGTGTTGAGG -> ATCTCTTCTGGTGTTGAGGA
GATGAAAACCGGTGAGTAGC -> ATGAAAACCGGTGAGTAGCG
GATGAAATCCTTTGGCCAAA -> ATGAAATCCTTTGGCCAAAT
GATGCGAGTTGAGTTACTCA -> ATGCGAGTTGAGTTACTCAA
GATGGGAAAACTATCTGCTC -> ATGGGAAAACTATCTGCTCC
GATGGTCGGTTCGGTACACT -> ATGGTCGGTTCGGTACACTA
GATGTACCCCTTGTACACAA -> ATGTACCCCTTGTACACAAC
GATTCCACACAGTATGCTGT -> ATTCCACACAGTATGCTGTG
GATTCCGTTACCATCCCGCA -> ATTCCGTTACCATCCCGCAG
GATTCTTGTGACACTGCATT -> ATTCTTGTGACACTGCATTA
GATTTAGGCTGCCCGATGTA -> ATTTAGGCTGCCCGATGTAC
GATTTCCAGGTGTATTCGGC -> ATTTCCAGGTGTATTCGGCA
GATTTGGTGTACCCAAAATG -> ATTTGGTGTACCCAAAATGC
GCAAAGATTCCACACAGTAT -> CAAAGATTCCACACAGTATG
GCAAGCCTCCGATGCGAGTT -> CAAGCCTCCGATGCGAGTTG
GCAATCTGATTTAGGCTGCC -> CAATCTGATTTAGGCTGCCC
GCACACCCACAACCTGCGAA -> CACACCCACAACCTGCGAAT
GCACCCAGGGCCCAACGTCC -> CACCCAGGGCCCAACGTCCT
GCACGCTTCAAAGATATAGG -> CACGCTTCAAAGATATAGGG
GCACGGTTCAGGAGCCCACG -> CACGGTTCAGGAGCCCACGT
GCACTCCTTTCTTGAACTCA -> CACTCCTTTCTTGAACTCAA
GCACTTGCCATAGCCTCTTG -> CACTTGCCATAGCCTCTTGT
GCAGTGCGTACCTCCGACAC -> CAGTGCGTACCTCCGACACC
GCAGTTACGGCCGATGGGAA -> CAGTTACGGCCGATGGGAAA
GCATGAGTAACTGCTCTCAG -> CATGAGTAACTGCTCTCAGG
GCATGCGCACGCTTCAAAGA -> CATGCGCACGCTTCAAAGAT
GCATTAAAGGTTGGCACACC -> CATTAAAGGTTGGCACACCC
GCATTTTGCCGCACGGTTCA -> CATTTTGCCGCACGGTTCAG
GCCAAATTCCCACAAGCGTA -> CCAAATTCCCACAAGCGTAG
GCCAACCATTCCTTCCCTCA -> CCAACCATTCCTTCCCTCAT
GCCAATGTTGTTCCGTTATT -> CCAATGTTGTTCCGTTATTC
GCCAATTGACGAATCCAGGT -> CCAATTGACGAATCCAGGTA
GCCATAGCCTCTTGTGCGAA -> CCATAGCCTCTTGTGCGAAC
GCCATAGTCTGTAGCACTCC -> CCATAGTCTGTAGCACTCCT
GCCATTATGGATAGATTTCC -> CCATTATGGATAGATTTCCA
GCCCAACGTCCTATATGTTG -> CCCAACGTCCTATATGTTGA
GCCCACGTCTCGAACTCTGC -> CCCACGTCTCGAACTCTGCG
GCCCATGTTGGGATTCCGTT -> CCCATGTTGGGATTCCGTTA
GCCCCACTATTCATCCGTGC -> CCCCACTATTCATCCGTGCG
GCCCGATGTACCCCTTGTAC -> CCCGATGTACCCCTTGTACA
GCCCGGCCAACCATTCCTTC -> CCCGGCCAACCATTCCTTCC
GCCGATGGGAAAACTATCTG -> CCGATGGGAAAACTATCTGC
GCCGCACGGTTCAGGAGCCC -> CCGCACGGTTCAGGAGCCCA
GCCGCCAATTGACGAATCCA -> CCGCCAATTGACGAATCCAG
GCCTCAGGAGAATCGCATGA -> CCTCAGGAGAATCGCATGAG
GCCTCCGATGCGAGTTGAGT -> CCTCCGATGCGAGTTGAGTT
GCCTCTTGTGCGAACTCGGT -> CCTCTTGTGCGAACTCGGTG
GCGAACTCGGTGCCCATGTT -> CGAACTCGGTGCCCATGTTG
GCGAATGCTAGAGATCTCTT -> CGAATGCTAGAGATCTCTTC
GCGACAAAAGGCTTAAGACC -> CGACAAAAGGCTTAAGACCA
GCGAGTTGAGTTACTCAAGC -> CGAGTTGAGTTACTCAAGCA
GCGATAGGGGGGAGTGACCA -> CGATAGGGGGGAGTGACCAA
GCGCAATCTGATTTAGGCTG -> CGCAATCTGATTTAGGCTGC
GCGCACGCTTCAAAGATATA -> CGCACGCTTCAAAGATATAG
GCGCGTACCGGGTTGAATAC -> CGCGTACCGGGTTGAATACC
GCGCTCGACGAGTGCCATAG -> CGCTCGACGAGTGCCATAGT
GCGGCTGATAGGCCAATGTT -> CGGCTGATAGGCCAATGTTG
GCGGGTGAGCACCCAGGGCC -> CGGGTGAGCACCCAGGGCCC
GCGTACCGGGTTGAATACCC -> CGTACCGGGTTGAATACCCC
GCGTACCTCCGACACCGGAC -> CGTACCTCCGACACCGGACT
GCGTAGGAGGTGGCGGCTGA -> CGTAGGAGGTGGCGGCTGAT
GCGTGTGGCAGTGCGTACCT -> CGTGTGGCAGTGCGTACCTC
GCTAGAGATCTCTTCTGGTG -> CTAGAGATCTCTTCTGGTGT
GCTCCCCCAGCAAAGATTCC -> CTCCCCCAGCAAAGATTCCA
GCTCGACGAGTGCCATAGTC -> CTCGACGAGTGCCATAGTCT
GCTCGTGATTTGGTGTACCC -> CTCGTGATTTGGTGTACCCA
GCTCTCAGGCCGCCAATTGA -> CTCTCAGGCCGCCAATTGAC
GCTGATAGGCCAATGTTGTT -> CTGATAGGCCAATGTTGTTC
GCTGCCCGATGTACCCCTTG -> CTGCCCGATGTACCCCTTGT
GCTGTGACGTCAGATTCTTG -> CTGTGACGTCAGATTCTTGT
GCTTAAGACCATAACCTCTG -> CTTAAGACCATAACCTCTGT
GCTTCAAAGATATAGGGGTA -> CTTCAAAGATATAGGGGTAG
GCTTTCGCGATAGGGGGGAG -> CTTTCGCGATAGGGGGGAGT
GGAAAAACGCTCGTGATTTG -> GAAAAACGCTCGTGATTTGG
GGAAAAAGGCATGCGCACGC -> GAAAAAGGCATGCGCACGCT
GGAAAACTATCTGCTCCCCC -> GAAAACTATCTGCTCCCCCA
GGAAACGTGAGATGAAAACC -> GAAACGTGAGATGAAAACCG
GGAATGGACTCAGGGTGGAG -> GAATGGACTCAGGGTGGAGT
GGACTCAGGGTGGAGTGACT -> GACTCAGGGTGGAGTGACTG
GGACTGTGGCCTCAGGAGAA -> GACTGTGGCCTCAGGAGAAT
GGAGAATCGCATGAGTAACT -> GAGAATCGCATGAGTAACTG
GGAGCCCACGTCTCGAACTC -> GAGCCCACGTCTCGAACTCT
GGAGGTGGCGGCTGATAGGC -> GAGGTGGCGGCTGATAGGCC
GGAGTGACCAAACGGTTGTC -> GAGTGACCAAACGGTTGTCC
GGAGTGACTGACAGTGTAGA -> GAGTGACTGACAGTGTAGAG
GGATAGATTTCCAGGTGTAT -> GATAGATTTCCAGGTGTATT
GGATCCACGTCACGCAAGCC -> GATCCACGTCACGCAAGCCT
GGATGGTCGGTTCGGTACAC -> GATGGTCGGTTCGGTACACT
GGATTCCGTTACCATCCCGC -> GATTCCGTTACCATCCCGCA
GGCACACCCACAACCTGCGA -> GCACACCCACAACCTGCGAA
GGCACTTGCCATAGCCTCTT -> GCACTTGCCATAGCCTCTTG
GGCAGTGCGTACCTCCGACA -> GCAGTGCGTACCTCCGACAC
GGCATGCGCACGCTTCAAAG -> GCATGCGCACGCTTCAAAGA
GGCCAAATTCCCACAAGCGT -> GCCAAATTCCCACAAGCGTA
GGCCAACCATTCCTTCCCTC -> GCCAACCATTCCTTCCCTCA
GGCCAATGTTGTTCCGTTAT -> GCCAATGTTGTTCCGTTATT
GGCCCAACGTCCTATATGTT -> GCCCAACGTCCTATATGTTG
GGCCCCACTATTCATCCGTG -> GCCCCACTATTCATCCGTGC
GGCCGATGGGAAAACTATCT -> GCCGATGGGAAAACTATCTG
GGCCGCCAATTGACGAATCC -> GCCGCCAATTGACGAATCCA
GGCCTCAGGAGAATCGCATG -> GCCTCAGGAGAATCGCATGA
GGCGGCTGATAGGCCAATGT -> GCGGCTGATAGGCCAATGTT
GGCTGATAGGCCAATGTTGT -> GCTGATAGGCCAATGTTGTT
GGCTGCCCGATGTACCCCTT -> GCTGCCCGATGTACCCCTTG
GGCTTAAGACCATAACCTCT -> GCTTAAGACCATAACCTCTG
GGGAAAACTATCTGCTCCCC -> GGAAAACTATCTGCTCCCCC
GGGAAACGTGAGATGAAAAC -> GGAAACGTGAGATGAAAACC
GGGAGTGACCAAACGGTTGT -> GGAGTGACCAAACGGTTGTC
GGGATTCCGTTACCATCCCG -> GGATTCCGTTACCATCCCGC
GGGCCCAACGTCCTATATGT -> GGCCCAACGTCCTATATGTT
GGGCCCCACTATTCATCCGT -> GGCCCCACTATTCATCCGTG
GGGGAGTGACCAAACGGTTG -> GGGAGTGACCAAACGGTTGT
GGGGGAGTGACCAAACGGTT -> GGGGAGTGACCAAACGGTTG
GGGGGGAGTGACCAAACGGT -> GGGGGAGTGACCAAACGGTT
GGGGTAGTGCGCAATCTGAT -> GGGTAGTGCGCAATCTGATT
GGGTAGTGCGCAATCTGATT -> GGTAGTGCGCAATCTGATTT
GGGTGAGCACCCAGGGCCCA -> GGTGAGCACCCAGGGCCCAA
GGGTGGAGTGACTGACAGTG -> GGTGGAGTGACTGACAGTGT
GGGTTGAATACCCCGAGTAG -> GGTTGAATACCCCGAGTAGG
GGTACACTATTTGAGTCCTG -> GTACACTATTTGAGTCCTGG
GGTAGTGCGCAATCTGATTT -> GTAGTGCGCAATCTGATTTA
GGTATCCTTATGGGCCCCAC -> GTATCCTTATGGGCCCCACT
GGTATGCGACAAAAGGCTTA -> GTATGCGACAAAAGGCTTAA
GGTCGGTTCGGTACACTATT -> GTCGGTTCGGTACACTATTT
GGTGAGCACCCAGGGCCCAA -> GTGAGCACCCAGGGCCCAAC
GGTGAGTAGCGGGTGAGCAC -> GTGAGTAGCGGGTGAGCACC
GGTGCCCATGTTGGGATTCC -> GTGCCCATGTTGGGATTCCG
GGTGGAGTGACTGACAGTGT -> GTGGAGTGACTGACAGTGTA
GGTGGCGGCTGATAGGCCAA -> GTGGCGGCTGATAGGCCAAT
GGTGTACCCAAAATGCCCGG -> GTGTACCCAAAATGCCCGGC
GGTGTATTCGGCACTTGCCA -> GTGTATTCGGCACTTGCCAT
GGTGTTGAGGATGGTCGGTT -> GTGTTGAGGATGGTCGGTTC
GGTTCAGGAGCCCACGTCTC -> GTTCAGGAGCCCACGTCTCG
GGTTCGGTACACTATTTGAG -> GTTCGGTACACTATTTGAGT
GGTTGAATACCCCGAGTAGG -> GTTGAATACCCCGAGTAGGG
GGTTGGCACACCCACAACCT -> GTTGGCACACCCACAACCTG
GGTTGTCCCGAACCCGTACA -> GTTGTCCCGAACCCGTACAG
GTAACTGCTCTCAGGCCGCC -> TAACTGCTCTCAGGCCGCCA
GTACACAACCAACAGGTATC -> TACACAACCAACAGGTATCC
GTACACTATTTGAGTCCTGG -> TACACTATTTGAGTCCTGGA
GTACAGTCAGCGCTCGACGA -> TACAGTCAGCGCTCGACGAG
GTACCCAAAATGCCCGGCCA -> TACCCAAAATGCCCGGCCAA
GTACCCCTTGTACACAACCA -> TACCCCTTGTACACAACCAA
GTACCGGGTTGAATACCCCG -> TACCGGGTTGAATACCCCGA
GTACCTCCGACACCGGACTG -> TACCTCCGACACCGGACTGT
GTAGAGGATCCACGTCACGC -> TAGAGGATCCACGTCACGCA
GTAGCACTCCTTTCTTGAAC -> TAGCACTCCTTTCTTGAACT
GTAGCGGGTGAGCACCCAGG -> TAGCGGGTGAGCACCCAGGG
GTAGGAGGTGGCGGCTGATA -> TAGGAGGTGGCGGCTGATAG
GTAGGGAAACGTGAGATGAA -> TAGGGAAACGTGAGATGAAA
GTAGTGCGCAATCTGATTTA -> TAGTGCGCAATCTGATTTAG
GTATCCTTATGGGCCCCACT -> TATCCTTATGGGCCCCACTA
GTATGCGACAAAAGGCTTAA -> TATGCGACAAAAGGCTTAAG
GTATGCTGTGACGTCAGATT -> TATGCTGTGACGTCAGATTC
GTATTCGGCACTTGCCATAG -> TATTCGGCACTTGCCATAGC
GTCACGCAAGCCTCCGATGC -> TCACGCAAGCCTCCGATGCG
GTCAGATTCTTGTGACACTG -> TCAGATTCTTGTGACACTGC
GTCAGCGCTCGACGAGTGCC -> TCAGCGCTCGACGAGTGCCA
GTCCCGAACCCGTACAGTCA -> TCCCGAACCCGTACAGTCAG
GTCCTATATGTTGATGAAAT -> TCCTATATGTTGATGAAATC
GTCCTGGAAAAACGCTCGTG -> TCCTGGAAAAACGCTCGTGA
GTCGGTTCGGTACACTATTT -> TCGGTTCGGTACACTATTTG
GTCTCGAACTCTGCGTGTGG -> TCTCGAACTCTGCGTGTGGC
GTCTGTAGCACTCCTTTCTT -> TCTGTAGCACTCCTTTCTTG
GTGACACTGCATTAAAGGTT -> TGACACTGCATTAAAGGTTG
GTGACCAAACGGTTGTCCCG -> TGACCAAACGGTTGTCCCGA
GTGACGTCAGATTCTTGTGA -> TGACGTCAGATTCTTGTGAC
GTGACTGACAGTGTAGAGGA -> TGACTGACAGTGTAGAGGAT
GTGAGATGAAAACCGGTGAG -> TGAGATGAAAACCGGTGAGT
GTGAGCACCCAGGGCCCAAC -> TGAGCACCCAGGGCCCAACG
GTGAGTAGCGGGTGAGCACC -> TGAGTAGCGGGTGAGCACCC
GTGATTTGGTGTACCCAAAA -> TGATTTGGTGTACCCAAAAT
GTGCCATAGTCTGTAGCACT -> TGCCATAGTCTGTAGCACTC
GTGCCCATGTTGGGATTCCG -> TGCCCATGTTGGGATTCCGT
GTGCGAACTCGGTGCCCATG -> TGCGAACTCGGTGCCCATGT
GTGCGCAATCTGATTTAGGC -> TGCGCAATCTGATTTAGGCT
GTGCGCGTACCGGGTTGAAT -> TGCGCGTACCGGGTTGAATA
GTGCGTACCTCCGACACCGG -> TGCGTACCTCCGACACCGGA
GTGGAGTGACTGACAGTGTA -> TGGAGTGACTGACAGTGTAG
GTGGCAGTGCGTACCTCCGA -> TGGCAGTGCGTACCTCCGAC
GTGGCCTCAGGAGAATCGCA -> TGGCCTCAGGAGAATCGCAT
GTGGCGGCTGATAGGCCAAT -> TGGCGGCTGATAGGCCAATG
GTGTACCCAAAATGCCCGGC -> TGTACCCAAAATGCCCGGCC
GTGTAGAGGATCCACGTCAC -> TGTAGAGGATCCACGTCACG
GTGTATTCGGCACTTGCCAT -> TGTATTCGGCACTTGCCATA
GTGTGGCAGTGCGTACCTCC -> TGTGGCAGTGCGTACCTCCG
GTGTTGAGGATGGTCGGTTC -> TGTTGAGGATGGTCGGTTCG
GTTACCATCCCGCAGTTACG -> TTACCATCCCGCAGTTACGG
GTTACGGCCGATGGGAAAAC -> TTACGGCCGATGGGAAAACT
GTTACTCAAGCATTTTGCCG -> TTACTCAAGCATTTTGCCGC
GTTATGTTGCTTTCGCGATA -> TTATGTTGCTTTCGCGATAG
GTTCAGGAGCCCACGTCTCG -> TTCAGGAGCCCACGTCTCGA
GTTCCGTTATTCGAAGTAGC -> TTCCGTTATTCGAAGTAGCT
GTTCGGTACACTATTTGAGT -> TTCGGTACACTATTTGAGTC
GTTCTACGGAAAAAGGCATG -> TTCTACGGAAAAAGGCATGC
GTTGAATACCCCGAGTAGGG -> TTGAATACCCCGAGTAGGGA
GTTGAGGATGGTCGGTTCGG -> TTGAGGATGGTCGGTTCGGT
GTTGAGTTACTCAAGCATTT -> TTGAGTTACTCAAGCATTTT
GTTGATGAAATCCTTTGGCC -> TTGATGAAATCCTTTGGCCA
GTTGCTTTCGCGATAGGGGG -> TTGCTTTCGCGATAGGGGGG
GTTGGCACACCCACAACCTG -> TTGGCACACCCACAACCTGC
GTTGGGATTCCGTTACCATC -> TTGGGATTCCGTTACCATCC
GTTGTCCCGAACCCGTACAG -> TTGTCCCGAACCCGTACAGT
GTTGTTCCGTTATTCGAAGT -> TTGTTCCGTTATTCGAAGTA
TAAAGGTTGGCACACCCACA -> AAAGGTTGGCACACCCACAA
TAACCTCTGTTATGTTGCTT -> AACCTCTGTTATGTTGCTTT
TAACTGCTCTCAGGCCGCCA -> AACTGCTCTCAGGCCGCCAA
TAAGACCATAACCTCTGTTA -> AAGACCATAACCTCTGTTAT
TACACAACCAACAGGTATCC -> ACACAACCAACAGGTATCCT
TACACTATTTGAGTCCTGGA -> ACACTATTTGAGTCCTGGAA
TACAGTCAGCGCTCGACGAG -> ACAGTCAGCGCTCGACGAGT
TACCATCCCGCAGTTACGGC -> ACCATCCCGCAGTTACGGCC
TACCCAAAATGCCCGGCCAA -> ACCCAAAATGCCCGGCCAAC
TACCCCGAGTAGGGAAACGT -> ACCCCGAGTAGGGAAACGTG
TACCCCTTGTACACAACCAA -> ACCCCTTGTACACAACCAAC
TACCGGGTTGAATACCCCGA -> ACCGGGTTGAATACCCCGAG
TACCTCCGACACCGGACTGT -> ACCTCCGACACCGGACTGTG
TACCTGTTCTACGGAAAAAG -> ACCTGTTCTACGGAAAAAGG
TACGGAAAAAGGCATGCGCA -> ACGGAAAAAGGCATGCGCAC
TACGGCCGATGGGAAAACTA -> ACGGCCGATGGGAAAACTAT
TACTCAAGCATTTTGCCGCA -> ACTCAAGCATTTTGCCGCAC
TAGAGATCTCTTCTGGTGTT -> AGAGATCTCTTCTGGTGTTG
TAGAGGATCCACGTCACGCA -> AGAGGATCCACGTCACGCAA
TAGATTTCCAGGTGTATTCG -> AGATTTCCAGGTGTATTCGG
TAGCACTCCTTTCTTGAACT -> AGCACTCCTTTCTTGAACTC
TAGCCTCTTGTGCGAACTCG -> AGCCTCTTGTGCGAACTCGG
TAGCGGGTGAGCACCCAGGG -> AGCGGGTGAGCACCCAGGGC
TAGGAGGTGGCGGCTGATAG -> AGGAGGTGGCGGCTGATAGG
TAGGCCAATGTTGTTCCGTT -> AGGCCAATGTTGTTCCGTTA
TAGGCTGCCCGATGTACCCC -> AGGCTGCCCGATGTACCCCT
TAGGGAAACGTGAGATGAAA -> AGGGAAACGTGAGATGAAAA
TAGGGGGGAGTGACCAAACG -> AGGGGGGAGTGACCAAACGG
TAGGGGTAGTGCGCAATCTG -> AGGGGTAGTGCGCAATCTGA
TAGTCTGTAGCACTCCTTTC -> AGTCTGTAGCACTCCTTTCT
TAGTGCGCAATCTGATTTAG -> AGTGCGCAATCTGATTTAGG
TATAGGGGTAGTGCGCAATC -> ATAGGGGTAGTGCGCAATCT
TATATGTTGATGAAATCCTT -> ATATGTTGATGAAATCCTTT
TATCCTTATGGGCCCCACTA -> ATCCTTATGGGCCCCACTAT
TATCTGCTCCCCCAGCAAAG -> ATCTGCTCCCCCAGCAAAGA
TATGCGACAAAAGGCTTAAG -> ATGCGACAAAAGGCTTAAGA
TATGCTGTGACGTCAGATTC -> ATGCTGTGACGTCAGATTCT
TATGGATAGATTTCCAGGTG -> ATGGATAGATTTCCAGGTGT
TATGGGCCCCACTATTCATC -> ATGGGCCCCACTATTCATCC
TATGTTGATGAAATCCTTTG -> ATGTTGATGAAATCCTTTGG
TATGTTGCTTTCGCGATAGG -> ATGTTGCTTTCGCGATAGGG
TATTCATCCGTGCGCGTACC -> ATTCATCCGTGCGCGTACCG
TATTCGGCACTTGCCATAGC -> ATTCGGCACTTGCCATAGCC
TATTTGAGTCCTGGAAAAAC -> ATTTGAGTCCTGGAAAAACG
TCAAACTCCTCTCCTGAGCC -> CAAACTCCTCTCCTGAGCCA
TCAAAGATATAGGGGTAGTG -> CAAAGATATAGGGGTAGTGC
TCAAGCATTTTGCCGCACGG -> CAAGCATTTTGCCGCACGGT
TCACGCAAGCCTCCGATGCG -> CACGCAAGCCTCCGATGCGA
TCAGATTCTTGTGACACTGC -> CAGATTCTTGTGACACTGCA
TCAGCGCTCGACGAGTGCCA -> CAGCGCTCGACGAGTGCCAT
TCAGGAGAATCGCATGAGTA -> CAGGAGAATCGCATGAGTAA
TCAGGAGCCCACGTCTCGAA -> CAGGAGCCCACGTCTCGAAC
TCAGGCCGCCAATTGACGAA -> CAGGCCGCCAATTGACGAAT
TCAGGGTGGAGTGACTGACA -> CAGGGTGGAGTGACTGACAG
TCATACCTGTTCTACGGAAA -> CATACCTGTTCTACGGAAAA
TCATCCGTGCGCGTACCGGG -> CATCCGTGCGCGTACCGGGT
TCCACACAGTATGCTGTGAC -> CCACACAGTATGCTGTGACG
TCCACGTCACGCAAGCCTCC -> CCACGTCACGCAAGCCTCCG
TCCAGGTATGCGACAAAAGG -> CCAGGTATGCGACAAAAGGC
TCCAGGTGTATTCGGCACTT -> CCAGGTGTATTCGGCACTTG
TCCCACAAGCGTAGGAGGTG -> CCCACAAGCGTAGGAGGTGG
TCCCCCAGCAAAGATTCCAC -> CCCCCAGCAAAGATTCCACA
TCCCGAACCCGTACAGTCAG -> CCCGAACCCGTACAGTCAGC
TCCCGCAGTTACGGCCGATG -> CCCGCAGTTACGGCCGATGG
TCCCTCATACCTGTTCTACG -> CCCTCATACCTGTTCTACGG
TCCGACACCGGACTGTGGCC -> CCGACACCGGACTGTGGCCT
TCCGATGCGAGTTGAGTTAC -> CCGATGCGAGTTGAGTTACT
TCCGTGCGCGTACCGGGTTG -> CCGTGCGCGTACCGGGTTGA
TCCGTTACCATCCCGCAGTT -> CCGTTACCATCCCGCAGTTA
TCCTATATGTTGATGAAATC -> CCTATATGTTGATGAAATCC
TCCTCTCCTGAGCCATTATG -> CCTCTCCTGAGCCATTATGG
TCCTGAGCCATTATGGATAG -> CCTGAGCCATTATGGATAGA
TCCTGGAAAAACGCTCGTGA -> CCTGGAAAAACGCTCGTGAT
TCCTTATGGGCCCCACTATT -> CCTTATGGGCCCCACTATTC
TCCTTCCCTCATACCTGTTC -> CCTTCCCTCATACCTGTTCT
TCCTTTCTTGAACTCAAACT -> CCTTTCTTGAACTCAAACTC
TCCTTTGGCCAAATTCCCAC -> CCTTTGGCCAAATTCCCACA
TCGAACTCTGCGTGTGGCAG -> CGAACTCTGCGTGTGGCAGT
TCGACGAGTGCCATAGTCTG -> CGACGAGTGCCATAGTCTGT
TCGCATGAGTAACTGCTCTC -> CGCATGAGTAACTGCTCTCA
TCGCGATAGGGGGGAGTGAC -> CGCGATAGGGGGGAGTGACC
TCGGCACTTGCCATAGCCTC -> CGGCACTTGCCATAGCCTCT
TCGGTACACTATTTGAGTCC -> CGGTACACTATTTGAGTCCT
TCGGTGCCCATGTTGGGATT -> CGGTGCCCATGTTGGGATTC
TCGGTTCGGTACACTATTTG -> CGGTTCGGTACACTATTTGA
TCGTGATTTGGTGTACCCAA -> CGTGATTTGGTGTACCCAAA
TCTACGGAAAAAGGCATGCG -> CTACGGAAAAAGGCATGCGC
TCTCAGGCCGCCAATTGACG -> CTCAGGCCGCCAATTGACGA
TCTCCTGAGCCATTATGGAT -> CTCCTGAGCCATTATGGATA
TCTCGAACTCTGCGTGTGGC -> CTCGAACTCTGCGTGTGGCA
TCTCTTCTGGTGTTGAGGAT -> CTCTTCTGGTGTTGAGGATG
TCTGATTTAGGCTGCCCGAT -> CTGATTTAGGCTGCCCGATG
TCTGCGTGTGGCAGTGCGTA -> CTGCGTGTGGCAGTGCGTAC
TCTGCTCCCCCAGCAAAGAT -> CTGCTCCCCCAGCAAAGATT
TCTGGTGTTGAGGATGGTCG -> CTGGTGTTGAGGATGGTCGG
TCTGTAGCACTCCTTTCTTG -> CTGTAGCACTCCTTTCTTGA
TCTGTTATGTTGCTTTCGCG -> CTGTTATGTTGCTTTCGCGA
TCTTCTGGTGTTGAGGATGG -> CTTCTGGTGTTGAGGATGGT
TCTTGAACTCAAACTCCTCT -> CTTGAACTCAAACTCCTCTC
TCTTGTGACACTGCATTAAA -> CTTGTGACACTGCATTAAAG
TCTTGTGCGAACTCGGTGCC -> CTTGTGCGAACTCGGTGCCC
TGAAAACCGGTGAGTAGCGG -> GAAAACCGGTGAGTAGCGGG
TGAAATCCTTTGGCCAAATT -> GAAATCCTTTGGCCAAATTC
TGAACTCAAACTCCTCTCCT -> GAACTCAAACTCCTCTCCTG
TGAATACCCCGAGTAGGGAA -> GAATACCCCGAGTAGGGAAA
TGACACTGCATTAAAGGTTG -> GACACTGCATTAAAGGTTGG
TGACAGTGTAGAGGATCCAC -> GACAGTGTAGAGGATCCACG
TGACCAAACGGTTGTCCCGA -> GACCAAACGGTTGTCCCGAA
TGACGAATCCAGGTATGCGA -> GACGAATCCAGGTATGCGAC
TGACGTCAGATTCTTGTGAC -> GACGTCAGATTCTTGTGACA
TGACTGACAGTGTAGAGGAT -> GACTGACAGTGTAGAGGATC
TGAGATGAAAACCGGTGAGT -> GAGATGAAAACCGGTGAGTA
TGAGCACCCAGGGCCCAACG -> GAGCACCCAGGGCCCAACGT
TGAGCCATTATGGATAGATT -> GAGCCATTATGGATAGATTT
TGAGGATGGTCGGTTCGGTA -> GAGGATGGTCGGTTCGGTAC
TGAGTAACTGCTCTCAGGCC -> GAGTAACTGCTCTCAGGCCG
TGAGTAGCGGGTGAGCACCC -> GAGTAGCGGGTGAGCACCCA
TGAGTCCTGGAAAAACGCTC -> GAGTCCTGGAAAAACGCTCG
TGAGTTACTCAAGCATTTTG -> GAGTTACTCAAGCATTTTGC
TGATAGGCCAATGTTGTTCC -> GATAGGCCAATGTTGTTCCG
TGATGAAATCCTTTGGCCAA -> GATGAAATCCTTTGGCCAAA
TGATTTAGGCTGCCCGATGT -> GATTTAGGCTGCCCGATGTA
TGATTTGGTGTACCCAAAAT -> GATTTGGTGTACCCAAAATG
TGCATTAAAGGTTGGCACAC -> GCATTAAAGGTTGGCACACC
TGCCATAGCCTCTTGTGCGA -> GCCATAGCCTCTTGTGCGAA
TGCCATAGTCTGTAGCACTC -> GCCATAGTCTGTAGCACTCC
TGCCCATGTTGGGATTCCGT -> GCCCATGTTGGGATTCCGTT
TGCCCGATGTACCCCTTGTA -> GCCCGATGTACCCCTTGTAC
TGCCCGGCCAACCATTCCTT -> GCCCGGCCAACCATTCCTTC
TGCCGCACGGTTCAGGAGCC -> GCCGCACGGTTCAGGAGCCC
TGCGAACTCGGTGCCCATGT -> GCGAACTCGGTGCCCATGTT
TGCGAATGCTAGAGATCTCT -> GCGAATGCTAGAGATCTCTT
TGCGACAAAAGGCTTAAGAC -> GCGACAAAAGGCTTAAGACC
TGCGAGTTGAGTTACTCAAG -> GCGAGTTGAGTTACTCAAGC
TGCGCAATCTGATTTAGGCT -> GCGCAATCTGATTTAGGCTG
TGCGCACGCTTCAAAGATAT -> GCGCACGCTTCAAAGATATA
TGCGCGTACCGGGTTGAATA -> GCGCGTACCGGGTTGAATAC
TGCGTACCTCCGACACCGGA -> GCGTACCTCCGACACCGGAC
TGCGTGTGGCAGTGCGTACC -> GCGTGTGGCAGTGCGTACCT
TGCTAGAGATCTCTTCTGGT -> GCTAGAGATCTCTTCTGGTG
TGCTCCCCCAGCAAAGATTC -> GCTCCCCCAGCAAAGATTCC
TGCTCTCAGGCCGCCAATTG -> GCTCTCAGGCCGCCAATTGA
TGCTGTGACGTCAGATTCTT -> GCTGTGACGTCAGATTCTTG
TGCTTTCGCGATAGGGGGGA -> GCTTTCGCGATAGGGGGGAG
TGGAAAAACGCTCGTGATTT -> GGAAAAACGCTCGTGATTTG
TGGACTCAGGGTGGAGTGAC -> GGACTCAGGGTGGAGTGACT
TGGAGTGACTGACAGTGTAG -> GGAGTGACTGACAGTGTAGA
TGGATAGATTTCCAGGTGTA -> GGATAGATTTCCAGGTGTAT
TGGCACACCCACAACCTGCG -> GGCACACCCACAACCTGCGA
TGGCAGTGCGTACCTCCGAC -> GGCAGTGCGTACCTCCGACA
TGGCCAAATTCCCACAAGCG -> GGCCAAATTCCCACAAGCGT
TGGCCTCAGGAGAATCGCAT -> GGCCTCAGGAGAATCGCATG
TGGCGGCTGATAGGCCAATG -> GGCGGCTGATAGGCCAATGT
TGGGAAAACTATCTGCTCCC -> GGGAAAACTATCTGCTCCCC
TGGGATTCCGTTACCATCCC -> GGGATTCCGTTACCATCCCG
TGGGCCCCACTATTCATCCG -> GGGCCCCACTATTCATCCGT
TGGTCGGTTCGGTACACTAT -> GGTCGGTTCGGTACACTATT
TGGTGTACCCAAAATGCCCG -> GGTGTACCCAAAATGCCCGG
TGGTGTTGAGGATGGTCGGT -> GGTGTTGAGGATGGTCGGTT
TGTACACAACCAACAGGTAT -> GTACACAACCAACAGGTATC
TGTACCCAAAATGCCCGGCC -> GTACCCAAAATGCCCGGCCA
TGTACCCCTTGTACACAACC -> GTACCCCTTGTACACAACCA
TGTAGAGGATCCACGTCACG -> GTAGAGGATCCACGTCACGC
TGTAGCACTCCTTTCTTGAA -> GTAGCACTCCTTTCTTGAAC
TGTATTCGGCACTTGCCATA -> GTATTCGGCACTTGCCATAG
TGTCCCGAACCCGTACAGTC -> GTCCCGAACCCGTACAGTCA
TGTGACACTGCATTAAAGGT -> GTGACACTGCATTAAAGGTT
TGTGACGTCAGATTCTTGTG -> GTGACGTCAGATTCTTGTGA
TGTGCGAACTCGGTGCCCAT -> GTGCGAACTCGGTGCCCATG
TGTGGCAGTGCGTACCTCCG -> GTGGCAGTGCGTACCTCCGA
TGTGGCCTCAGGAGAATCGC -> GTGGCCTCAGGAGAATCGCA
TGTTATGTTGCTTTCGCGAT -> GTTATGTTGCTTTCGCGATA
TGTTCCGTTATTCGAAGTAG -> GTTCCGTTATTCGAAGTAGC
TGTTCTACGGAAAAAGGCAT -> GTTCTACGGAAAAAGGCATG
TGTTGAGGATGGTCGGTTCG -> GTTGAGGATGGTCGGTTCGG
TGTTGATGAAATCCTTTGGC -> GTTGATGAAATCCTTTGGCC
TGTTGCTTTCGCGATAGGGG -> GTTGCTTTCGCGATAGGGGG
TGTTGGGATTCCGTTACCAT -> GTTGGGATTCCGTTACCATC
TGTTGTTCCGTTATTCGAAG -> GTTGTTCCGTTATTCGAAGT
TTAAAGGTTGGCACACCCAC -> TAAAGGTTGGCACACCCACA
TTAAGACCATAACCTCTGTT -> TAAGACCATAACCTCTGTTA
TTACCATCCCGCAGTTACGG -> TACCATCCCGCAGTTACGGC
TTACGGCCGATGGGAAAACT -> TACGGCCGATGGGAAAACTA
TTACTCAAGCATTTTGCCGC -> TACTCAAGCATTTTGCCGCA
TTAGGCTGCCCGATGTACCC -> TAGGCTGCCCGATGTACCCC
TTATGGATAGATTTCCAGGT -> TATGGATAGATTTCCAGGTG
TTATGGGCCCCACTATTCAT -> TATGGGCCCCACTATTCATC
TTATGTTGCTTTCGCGATAG -> TATGTTGCTTTCGCGATAGG
TTCAAAGATATAGGGGTAGT -> TCAAAGATATAGGGGTAGTG
TTCAGGAGCCCACGTCTCGA -> TCAGGAGCCCACGTCTCGAA
TTCATCCGTGCGCGTACCGG -> TCATCCGTGCGCGTACCGGG
TTCCACACAGTATGCTGTGA -> TCCACACAGTATGCTGTGAC
TTCCAGGTGTATTCGGCACT -> TCCAGGTGTATTCGGCACTT
TTCCCACAAGCGTAGGAGGT -> TCCCACAAGCGTAGGAGGTG
TTCCCTCATACCTGTTCTAC -> TCCCTCATACCTGTTCTACG
TTCCGTTACCATCCCGCAGT -> TCCGTTACCATCCCGCAGTT
TTCCTTCCCTCATACCTGTT -> TCCTTCCCTCATACCTGTTC
TTCGCGATAGGGGGGAGTGA -> TCGCGATAGGGGGGAGTGAC
TTCGGCACTTGCCATAGCCT -> TCGGCACTTGCCATAGCCTC
TTCGGTACACTATTTGAGTC -> TCGGTACACTATTTGAGTCC
TTCTACGGAAAAAGGCATGC -> TCTACGGAAAAAGGCATGCG
TTCTGGTGTTGAGGATGGTC -> TCTGGTGTTGAGGATGGTCG
TTCTTGAACTCAAACTCCTC -> TCTTGAACTCAAACTCCTCT
TTCTTGTGACACTGCATTAA -> TCTTGTGACACTGCATTAAA
TTGAACTCAAACTCCTCTCC -> TGAACTCAAACTCCTCTCCT
TTGAATACCCCGAGTAGGGA -> TGAATACCCCGAGTAGGGAA
TTGACGAATCCAGGTATGCG -> TGACGAATCCAGGTATGCGA
TTGAGGATGGTCGGTTCGGT -> TGAGGATGGTCGGTTCGGTA
TTGAGTCCTGGAAAAACGCT -> TGAGTCCTGGAAAAACGCTC
TTGAGTTACTCAAGCATTTT -> TGAGTTACTCAAGCATTTTG
TTGATGAAATCCTTTGGCCA -> TGATGAAATCCTTTGGCCAA
TTGCCATAGCCTCTTGTGCG -> TGCCATAGCCTCTTGTGCGA
TTGCCGCACGGTTCAGGAGC -> TGCCGCACGGTTCAGGAGCC
TTGCTTTCGCGATAGGGGGG -> TGCTTTCGCGATAGGGGGGA
TTGGCACACCCACAACCTGC -> TGGCACACCCACAACCTGCG
TTGGCCAAATTCCCACAAGC -> TGGCCAAATTCCCACAAGCG
TTGGGATTCCGTTACCATCC -> TGGGATTCCGTTACCATCCC
TTGGTGTACCCAAAATGCCC -> TGGTGTACCCAAAATGCCCG
TTGTACACAACCAACAGGTA -> TGTACACAACCAACAGGTAT
TTGTCCCGAACCCGTACAGT -> TGTCCCGAACCCGTACAGTC
TTGTGACACTGCATTAAAGG -> TGTGACACTGCATTAAAGGT
TTGTGCGAACTCGGTGCCCA -> TGTGCGAACTCGGTGCCCAT
TTGTTCCGTTATTCGAAGTA -> TGTTCCGTTATTCGAAGTAG
TTTAGGCTGCCCGATGTACC -> TTAGGCTGCCCGATGTACCC
TTTCCAGGTGTATTCGGCAC -> TTCCAGGTGTATTCGGCACT
TTTCGCGATAGGGGGGAGTG -> TTCGCGATAGGGGGGAGTGA
TTTCTTGAACTCAAACTCCT -> TTCTTGAACTCAAACTCCTC
TTTGAGTCCTGGAAAAACGC -> TTGAGTCCTGGAAAAACGCT
TTTGCCGCACGGTTCAGGAG -> TTGCCGCACGGTTCAGGAGC
TTTGGCCAAATTCCCACAAG -> TTGGCCAAATTCCCACAAGC
TTTGGTGTACCCAAAATGCC -> TTGGTGTACCCAAAATGCCC
TTTTGCCGCACGGTTCAGGA -> TTTGCCGCACGGTTCAGGAG
