AAACCACGGGT -> AACCACGGGTA
AAAACCACGGG -> AAACCACGGGT
AAACGCATAGC -> AACGCATAGCG
AAAACGCATAG -> AAACGCATAGC
AAAGAATGTCT -> AAGAATGTCTG
AAAAGAATGTC -> AAAGAATGTCT
AAAGGAGATGA -> AAGGAGATGAC
AAAAGGAGATG -> AAAGGAGATGA
AAATCGGTCCT -> AATCGGTCCTA
AAAATCGGTCC -> AAATCGGTCCT
AAATTCCCGAT -> AATTCCCGATA
AAAATTCCCGA -> AAATTCCCGAT
AACACTACTTT -> ACACTACTTTC
AAACACTACTT -> AACACTACTTT
AACCACGGGTA -> ACCACGGGTAA
AACCGACCCAC -> ACCGACCCACC
AAACCGACCCA -> AACCGACCCAC
AACCTCCAGTA -> ACCTCCAGTAA
AAACCTCCAGT -> AACCTCCAGTA
AACGCATAGCG -> ACGCATAGCGT
AACGCGTGTGT -> ACGCGTGTGTC
AAACGCGTGTG -> AACGCGTGTGT
AACTGCATTGG -> ACTGCATTGGT
AAACTGCATTG -> AACTGCATTGG
AAGAAGCCACC -> AGAAGCCACCC
AAAGAAGCCAC -> AAGAAGCCACC
AAGAATGCTGT -> AGAATGCTGTG
AAAGAATGCTG -> AAGAATGCTGT
AAGAATGTCTG -> AGAATGTCTGC
AAGGAGATGAC -> AGGAGATGACC
AAGTGCGGTGA -> AGTGCGGTGAC
AAAGTGCGGTG -> AAGTGCGGTGA
AATCGGTCCTA -> ATCGGTCCTAG
AATGTTCGGGC -> ATGTTCGGGCC
AAATGTTCGGG -> AATGTTCGGGC
AATTCCCGATA -> ATTCCCGATAT
AATTTCCAAGG -> ATTTCCAAGGG
AAATTTCCAAG -> AATTTCCAAGG
ACAAAATCGGT -> CAAAATCGGTC
AACAAAATCGG -> ACAAAATCGGT
ACAAGCCTCTC -> CAAGCCTCTCC
AACAAGCCTCT -> ACAAGCCTCTC
ACACAACTGGG -> CACAACTGGGT
AACACAACTGG -> ACACAACTGGG
ACACCGCATGC -> CACCGCATGCC
AACACCGCATG -> ACACCGCATGC
ACACCGCTGTT -> CACCGCTGTTG
AACACCGCTGT -> ACACCGCTGTT
ACACTACTTTC -> CACTACTTTCG
ACAGGCCGTAT -> CAGGCCGTATT
AACAGGCCGTA -> ACAGGCCGTAT
ACATCGGTTAG -> CATCGGTTAGG
AACATCGGTTA -> ACATCGGTTAG
ACATCTACTCC -> CATCTACTCCG
AACATCTACTC -> ACATCTACTCC
ACCAAAACGCA -> CCAAAACGCAT
AACCAAAACGC -> ACCAAAACGCA
ACCACGGGTAA -> CCACGGGTAAT
ACCACGTTGTA -> CCACGTTGTAT
AACCACGTTGT -> ACCACGTTGTA
ACCAGAACTTA -> CCAGAACTTAC
AACCAGAACTT -> ACCAGAACTTA
ACCATGTCTCC -> CCATGTCTCCG
AACCATGTCTC -> ACCATGTCTCC
ACCATTCAATG -> CCATTCAATGA
AACCATTCAAT -> ACCATTCAATG
ACCCCTTTAAG -> CCCCTTTAAGC
AACCCCTTTAA -> ACCCCTTTAAG
ACCCGTGGATA -> CCCGTGGATAC
AACCCGTGGAT -> ACCCGTGGATA
ACCCTTGAGTA -> CCCTTGAGTAG
AACCCTTGAGT -> ACCCTTGAGTA
ACCGACCCACC -> CCGACCCACCG
ACCTCCAGTAA -> CCTCCAGTAAT
ACCTCCGGACA -> CCTCCGGACAA
AACCTCCGGAC -> ACCTCCGGACA
ACGAACCCGTG -> CGAACCCGTGG
AACGAACCCGT -> ACGAACCCGTG
ACGAATCTCGT -> CGAATCTCGTC
AACGAATCTCG -> ACGAATCTCGT
ACGCATAGCGT -> CGCATAGCGTC
ACGCGTGTGTC -> CGCGTGTGTCG
ACGTAACCATT -> CGTAACCATTC
AACGTAACCAT -> ACGTAACCATT
ACTACGTTGCT -> CTACGTTGCTA
AACTACGTTGC -> ACTACGTTGCT
ACTATGCGATG -> CTATGCGATGC
AACTATGCGAT -> ACTATGCGATG
ACTCAGATTCG -> CTCAGATTCGT
AACTCAGATTC -> ACTCAGATTCG
ACTCTCGCTAC -> CTCTCGCTACC
AACTCTCGCTA -> ACTCTCGCTAC
ACTGACGGTCT -> CTGACGGTCTC
AACTGACGGTC -> ACTGACGGTCT
ACTGCATTGGT -> CTGCATTGGTA
ACTGCGTCTAG -> CTGCGTCTAGC
AACTGCGTCTA -> ACTGCGTCTAG
ACTGGGTATCA -> CTGGGTATCAT
AACTGGGTATC -> ACTGGGTATCA
ACTGTTGTGAG -> CTGTTGTGAGC
AACTGTTGTGA -> ACTGTTGTGAG
ACTTACATGGT -> CTTACATGGTC
AACTTACATGG -> ACTTACATGGT
ACTTGATGGTG -> CTTGATGGTGA
AACTTGATGGT -> ACTTGATGGTG
ACTTGTTAAAA -> CTTGTTAAAAC
AACTTGTTAAA -> ACTTGTTAAAA
ACTTTGTCTAG -> CTTTGTCTAGT
AACTTTGTCTA -> ACTTTGTCTAG
AGAACGAATCT -> GAACGAATCTC
AAGAACGAATC -> AGAACGAATCT
AGAAGCCACCC -> GAAGCCACCCA
AGAATGCTGTG -> GAATGCTGTGT
AGAATGTCTGC -> GAATGTCTGCC
AGACCCTGTCC -> GACCCTGTCCC
AAGACCCTGTC -> AGACCCTGTCC
AGATACGCCGG -> GATACGCCGGA
AAGATACGCCG -> AGATACGCCGG
AGATGTCGTCA -> GATGTCGTCAG
AAGATGTCGTC -> AGATGTCGTCA
AGCAGCGGATT -> GCAGCGGATTT
AAGCAGCGGAT -> AGCAGCGGATT
AGCCAATTCAA -> GCCAATTCAAT
AAGCCAATTCA -> AGCCAATTCAA
AGCCACCCATA -> GCCACCCATAG
AAGCCACCCAT -> AGCCACCCATA
AGCCACGGGTA -> GCCACGGGTAA
AAGCCACGGGT -> AGCCACGGGTA
AGCCATAGACT -> GCCATAGACTT
AAGCCATAGAC -> AGCCATAGACT
AGCCCCCCTAG -> GCCCCCCTAGA
AAGCCCCCCTA -> AGCCCCCCTAG
AGCCTCTCCGC -> GCCTCTCCGCG
AAGCCTCTCCG -> AGCCTCTCCGC
AGCGCGAACAG -> GCGCGAACAGG
AAGCGCGAACA -> AGCGCGAACAG
AGCTGTTGCCC -> GCTGTTGCCCG
AAGCTGTTGCC -> AGCTGTTGCCC
AGCTTAACCAA -> GCTTAACCAAA
AAGCTTAACCA -> AGCTTAACCAA
AGCTTTGAAGC -> GCTTTGAAGCC
AAGCTTTGAAG -> AGCTTTGAAGC
AGGACCTCCTA -> GGACCTCCTAG
AAGGACCTCCT -> AGGACCTCCTA
AGGAGATGACC -> GGAGATGACCG
AGGCTGTCACA -> GGCTGTCACAG
AAGGCTGTCAC -> AGGCTGTCACA
AGGGCATCCTC -> GGGCATCCTCT
AAGGGCATCCT -> AGGGCATCCTC
AGGGGATAAGT -> GGGGATAAGTG
AAGGGGATAAG -> AGGGGATAAGT
AGGTAGCACTG -> GGTAGCACTGT
AAGGTAGCACT -> AGGTAGCACTG
AGGTGCACATG -> GGTGCACATGA
AAGGTGCACAT -> AGGTGCACATG
AGTCGAACCAT -> GTCGAACCATG
AAGTCGAACCA -> AGTCGAACCAT
AGTGCGGTATC -> GTGCGGTATCA
AAGTGCGGTAT -> AGTGCGGTATC
AGTGCGGTGAC -> GTGCGGTGACT
AGTTGTGTAGG -> GTTGTGTAGGC
AAGTTGTGTAG -> AGTTGTGTAGG
AGTTTCTCCGG -> GTTTCTCCGGA
AAGTTTCTCCG -> AGTTTCTCCGG
ATACCCGGCAT -> TACCCGGCATT
AATACCCGGCA -> ATACCCGGCAT
ATACCTCAAGG -> TACCTCAAGGA
AATACCTCAAG -> ATACCTCAAGG
ATACTCCGATT -> TACTCCGATTC
AATACTCCGAT -> ATACTCCGATT
ATAGAGAAACC -> TAGAGAAACCG
AATAGAGAAAC -> ATAGAGAAACC
ATAGCTTTCAA -> TAGCTTTCAAT
AATAGCTTTCA -> ATAGCTTTCAA
ATAGTCGGTCC -> TAGTCGGTCCT
AATAGTCGGTC -> ATAGTCGGTCC
ATCAATTCTGG -> TCAATTCTGGG
AATCAATTCTG -> ATCAATTCTGG
ATCGGATACAT -> TCGGATACATA
AATCGGATACA -> ATCGGATACAT
ATCGGCCGGAT -> TCGGCCGGATG
AATCGGCCGGA -> ATCGGCCGGAT
ATCGGTCCTAG -> TCGGTCCTAGT
ATCTCCTTCTC -> TCTCCTTCTCA
AATCTCCTTCT -> ATCTCCTTCTC
ATCTCGTCTTT -> TCTCGTCTTTT
AATCTCGTCTT -> ATCTCGTCTTT
ATCTGAACCAG -> TCTGAACCAGA
AATCTGAACCA -> ATCTGAACCAG
ATGACGGCCTC -> TGACGGCCTCT
AATGACGGCCT -> ATGACGGCCTC
ATGCGGGGATT -> TGCGGGGATTC
AATGCGGGGAT -> ATGCGGGGATT
ATGCTACCAAC -> TGCTACCAACA
AATGCTACCAA -> ATGCTACCAAC
ATGCTGTGTAG -> TGCTGTGTAGA
AATGCTGTGTA -> ATGCTGTGTAG
ATGGTGAATCG -> TGGTGAATCGG
AATGGTGAATC -> ATGGTGAATCG
ATGTCTGCCCG -> TGTCTGCCCGA
AATGTCTGCCC -> ATGTCTGCCCG
ATGTGCTGTTA -> TGTGCTGTTAG
AATGTGCTGTT -> ATGTGCTGTTA
ATGTTCGGGCC -> TGTTCGGGCCG
ATTCAATAGAG -> TTCAATAGAGA
AATTCAATAGA -> ATTCAATAGAG
ATTCACTAGCA -> TTCACTAGCAA
AATTCACTAGC -> ATTCACTAGCA
ATTCCCGATAT -> TTCCCGATATG
ATTCTGGCGAT -> TTCTGGCGATA
AATTCTGGCGA -> ATTCTGGCGAT
ATTCTGGGGTG -> TTCTGGGGTGT
AATTCTGGGGT -> ATTCTGGGGTG
ATTTCCAAGGG -> TTTCCAAGGGG
ATTTCCTGGTG -> TTTCCTGGTGG
AATTTCCTGGT -> ATTTCCTGGTG
CAAAATCGGTC -> AAAATCGGTCC
CAACACCGCTG -> AACACCGCTGT
ACAACACCGCT -> CAACACCGCTG
CAACCTCCGGA -> AACCTCCGGAC
ACAACCTCCGG -> CAACCTCCGGA
CAACTGGGTAT -> AACTGGGTATC
ACAACTGGGTA -> CAACTGGGTAT
CAAGCCTCTCC -> AAGCCTCTCCG
CAAGGGCATCC -> AAGGGCATCCT
ACAAGGGCATC -> CAAGGGCATCC
CAATTTCCTGG -> AATTTCCTGGT
ACAATTTCCTG -> CAATTTCCTGG
CACAACTGGGT -> ACAACTGGGTA
CACCCGCTTGA -> ACCCGCTTGAC
ACACCCGCTTG -> CACCCGCTTGA
CACCGCATGCC -> ACCGCATGCCT
CACCGCGGTCA -> ACCGCGGTCAC
ACACCGCGGTC -> CACCGCGGTCA
CACCGCTGTTG -> ACCGCTGTTGA
CACTACTTTCG -> ACTACTTTCGA
CACTTTCCACC -> ACTTTCCACCA
ACACTTTCCAC -> CACTTTCCACC
CAGAGGCGCTT -> AGAGGCGCTTC
ACAGAGGCGCT -> CAGAGGCGCTT
CAGAGGTAGAT -> AGAGGTAGATA
ACAGAGGTAGA -> CAGAGGTAGAT
CAGCAGGCGCA -> AGCAGGCGCAC
ACAGCAGGCGC -> CAGCAGGCGCA
CAGCTTTGTCG -> AGCTTTGTCGC
ACAGCTTTGTC -> CAGCTTTGTCG
CAGGCCGTATT -> AGGCCGTATTT
CAGTAATTCAC -> AGTAATTCACT
ACAGTAATTCA -> CAGTAATTCAC
CAGTCTGTCAC -> AGTCTGTCACT
ACAGTCTGTCA -> CAGTCTGTCAC
CAGTTCCCCCC -> AGTTCCCCCCG
ACAGTTCCCCC -> CAGTTCCCCCC
CATAAAATTCC -> ATAAAATTCCC
ACATAAAATTC -> CATAAAATTCC
CATAGGTACAA -> ATAGGTACAAG
ACATAGGTACA -> CATAGGTACAA
CATCGGTTAGG -> ATCGGTTAGGG
CATCTACTCCG -> ATCTACTCCGA
CATGAATAGCT -> ATGAATAGCTT
ACATGAATAGC -> CATGAATAGCT
CATGGTCCGAA -> ATGGTCCGAAG
ACATGGTCCGA -> CATGGTCCGAA
CATGTTATGGT -> ATGTTATGGTA
ACATGTTATGG -> CATGTTATGGT
CCAAAACGCAT -> CAAAACGCATA
CCAACACCGCA -> CAACACCGCAT
ACCAACACCGC -> CCAACACCGCA
CCACGGGTAAT -> CACGGGTAATC
CCACGTTGTAT -> CACGTTGTATA
CCACTAATCGG -> CACTAATCGGC
ACCACTAATCG -> CCACTAATCGG
CCAGAACTTAC -> CAGAACTTACA
CCAGCAAAGAA -> CAGCAAAGAAG
ACCAGCAAAGA -> CCAGCAAAGAA
CCAGCGCTAGC -> CAGCGCTAGCC
ACCAGCGCTAG -> CCAGCGCTAGC
CCATATGACGG -> CATATGACGGA
ACCATATGACG -> CCATATGACGG
CCATGTAAGCC -> CATGTAAGCCA
ACCATGTAAGC -> CCATGTAAGCC
CCATGTCTCCG -> CATGTCTCCGC
CCATTCAATGA -> CATTCAATGAC
CCCACCGTATG -> CCACCGTATGG
ACCCACCGTAT -> CCCACCGTATG
CCCATAGGGCT -> CCATAGGGCTC
ACCCATAGGGC -> CCCATAGGGCT
CCCCGGTGCGA -> CCCGGTGCGAC
ACCCCGGTGCG -> CCCCGGTGCGA
CCCCTATGGGA -> CCCTATGGGAG
ACCCCTATGGG -> CCCCTATGGGA
CCCCTTTAAGC -> CCCTTTAAGCT
CCCGCTTGACA -> CCGCTTGACAG
ACCCGCTTGAC -> CCCGCTTGACA
CCCGGCATTTA -> CCGGCATTTAA
ACCCGGCATTT -> CCCGGCATTTA
CCCGTGGATAC -> CCGTGGATACT
CCCTCGACCCC -> CCTCGACCCCT
ACCCTCGACCC -> CCCTCGACCCC
CCCTGTCCCCG -> CCTGTCCCCGG
ACCCTGTCCCC -> CCCTGTCCCCG
CCCTTGAGTAG -> CCTTGAGTAGT
CCGAAGCAGCG -> CGAAGCAGCGG
ACCGAAGCAGC -> CCGAAGCAGCG
CCGACCCACCG -> CGACCCACCGT
CCGCAGAGATC -> CGCAGAGATCG
ACCGCAGAGAT -> CCGCAGAGATC
CCGCATGCCTG -> CGCATGCCTGC
ACCGCATGCCT -> CCGCATGCCTG
CCGCGGTCACC -> CGCGGTCACCA
ACCGCGGTCAC -> CCGCGGTCACC
CCGCGTCACTG -> CGCGTCACTGC
ACCGCGTCACT -> CCGCGTCACTG
CCGCTGTTGAG -> CGCTGTTGAGT
ACCGCTGTTGA -> CCGCTGTTGAG
CCGGACACCCG -> CGGACACCCGC
ACCGGACACCC -> CCGGACACCCG
CCGTATGGAGC -> CGTATGGAGCC
ACCGTATGGAG -> CCGTATGGAGC
CCGTTCTTTAG -> CGTTCTTTAGG
ACCGTTCTTTA -> CCGTTCTTTAG
CCTAAGTTTCT -> CTAAGTTTCTC
ACCTAAGTTTC -> CCTAAGTTTCT
CCTAGGTGGAG -> CTAGGTGGAGC
ACCTAGGTGGA -> CCTAGGTGGAG
CCTCAAGGACC -> CTCAAGGACCT
ACCTCAAGGAC -> CCTCAAGGACC
CCTCCAGTAAT -> CTCCAGTAATA
CCTCCGGACAA -> CTCCGGACAAC
CCTCCTAGGAT -> CTCCTAGGATA
ACCTCCTAGGA -> CCTCCTAGGAT
CCTCGATAGGA -> CTCGATAGGAC
ACCTCGATAGG -> CCTCGATAGGA
CCTCGTCAAGC -> CTCGTCAAGCT
ACCTCGTCAAG -> CCTCGTCAAGC
CCTTGGCGTAG -> CTTGGCGTAGC
ACCTTGGCGTA -> CCTTGGCGTAG
CCTTTGTCGAT -> CTTTGTCGATT
ACCTTTGTCGA -> CCTTTGTCGAT
CGAACCCGTGG -> GAACCCGTGGA
CGAATCTCGTC -> GAATCTCGTCT
CGACCGTTCTT -> GACCGTTCTTT
ACGACCGTTCT -> CGACCGTTCTT
CGACTTTACTG -> GACTTTACTGA
ACGACTTTACT -> CGACTTTACTG
CGAGACCAGCG -> GAGACCAGCGC
ACGAGACCAGC -> CGAGACCAGCG
CGATCATACTG -> GATCATACTGA
ACGATCATACT -> CGATCATACTG
CGATGAATCTG -> GATGAATCTGA
ACGATGAATCT -> CGATGAATCTG
CGCATAGCGTC -> GCATAGCGTCG
CGCCGGACGAC -> GCCGGACGACT
ACGCCGGACGA -> CGCCGGACGAC
CGCGTGTGTCG -> GCGTGTGTCGC
CGCTCTCGATG -> GCTCTCGATGC
ACGCTCTCGAT -> CGCTCTCGATG
CGGAGCCAACA -> GGAGCCAACAC
ACGGAGCCAAC -> CGGAGCCAACA
CGGCCTCTACA -> GGCCTCTACAG
ACGGCCTCTAC -> CGGCCTCTACA
CGGGTAAACCC -> GGGTAAACCCC
ACGGGTAAACC -> CGGGTAAACCC
CGGGTAATCAA -> GGGTAATCAAT
ACGGGTAATCA -> CGGGTAATCAA
CGGTCTCGCCT -> GGTCTCGCCTA
ACGGTCTCGCC -> CGGTCTCGCCT
CGTAACCATTC -> GTAACCATTCA
CGTATTTAAGG -> GTATTTAAGGT
ACGTATTTAAG -> CGTATTTAAGG
CGTGGATCGCA -> GTGGATCGCAT
ACGTGGATCGC -> CGTGGATCGCA
CGTTAAATTTC -> GTTAAATTTCC
ACGTTAAATTT -> CGTTAAATTTC
CGTTGCTACAG -> GTTGCTACAGA
ACGTTGCTACA -> CGTTGCTACAG
CGTTGTATAGT -> GTTGTATAGTA
ACGTTGTATAG -> CGTTGTATAGT
CTAATCGGCCG -> TAATCGGCCGG
ACTAATCGGCC -> CTAATCGGCCG
CTACGTTGCTA -> TACGTTGCTAC
CTACTTTCGAA -> TACTTTCGAAG
ACTACTTTCGA -> CTACTTTCGAA
CTAGCAACAAA -> TAGCAACAAAA
ACTAGCAACAA -> CTAGCAACAAA
CTAGCTTAACT -> TAGCTTAACTG
ACTAGCTTAAC -> CTAGCTTAACT
CTATGCGATGC -> TATGCGATGCA
CTCAGATTCGT -> TCAGATTCGTT
CTCCAACAAGC -> TCCAACAAGCC
ACTCCAACAAG -> CTCCAACAAGC
CTCCGATATTG -> TCCGATATTGC
ACTCCGATATT -> CTCCGATATTG
CTCCGATTCTA -> TCCGATTCTAA
ACTCCGATTCT -> CTCCGATTCTA
CTCTCGCTACC -> TCTCGCTACCT
CTCTTGCAACT -> TCTTGCAACTA
ACTCTTGCAAC -> CTCTTGCAACT
CTGAACTCTCG -> TGAACTCTCGC
ACTGAACTCTC -> CTGAACTCTCG
CTGACGGTCTC -> TGACGGTCTCG
CTGAGGACAGC -> TGAGGACAGCT
ACTGAGGACAG -> CTGAGGACAGC
CTGATTCCTAC -> TGATTCCTACC
ACTGATTCCTA -> CTGATTCCTAC
CTGATTTTGGG -> TGATTTTGGGT
ACTGATTTTGG -> CTGATTTTGGG
CTGCATTAGAA -> TGCATTAGAAG
ACTGCATTAGA -> CTGCATTAGAA
CTGCATTGGTA -> TGCATTGGTAC
CTGCGTCTAGC -> TGCGTCTAGCC
CTGCTATCTGC -> TGCTATCTGCT
ACTGCTATCTG -> CTGCTATCTGC
CTGGGTATCAT -> TGGGTATCATA
CTGTCTTGGGA -> TGTCTTGGGAC
ACTGTCTTGGG -> CTGTCTTGGGA
CTGTGCGTAAG -> TGTGCGTAAGG
ACTGTGCGTAA -> CTGTGCGTAAG
CTGTTGTGAGC -> TGTTGTGAGCA
CTTAACTTTGT -> TTAACTTTGTC
ACTTAACTTTG -> CTTAACTTTGT
CTTACATGGTC -> TTACATGGTCC
CTTACTTAACT -> TTACTTAACTT
ACTTACTTAAC -> CTTACTTAACT
CTTGATGGTGA -> TTGATGGTGAA
CTTGATTCAAG -> TTGATTCAAGC
ACTTGATTCAA -> CTTGATTCAAG
CTTGCGTGGAA -> TTGCGTGGAAG
ACTTGCGTGGA -> CTTGCGTGGAA
CTTGTTAAAAC -> TTGTTAAAACC
CTTTACTGATT -> TTTACTGATTC
ACTTTACTGAT -> CTTTACTGATT
CTTTCCACCAT -> TTTCCACCATA
ACTTTCCACCA -> CTTTCCACCAT
CTTTCGAAGTT -> TTTCGAAGTTG
ACTTTCGAAGT -> CTTTCGAAGTT
CTTTCGGGAAA -> TTTCGGGAAAC
ACTTTCGGGAA -> CTTTCGGGAAA
CTTTGATTTGA -> TTTGATTTGAG
ACTTTGATTTG -> CTTTGATTTGA
CTTTGTCTAGT -> TTTGTCTAGTC
GAAACCGACCC -> AAACCGACCCA
AGAAACCGACC -> GAAACCGACCC
GAAAGAATGCT -> AAAGAATGCTG
AGAAAGAATGC -> GAAAGAATGCT
GAACGAACCCG -> AACGAACCCGT
AGAACGAACCC -> GAACGAACCCG
GAACGAATCTC -> AACGAATCTCG
GAACTCAGATT -> AACTCAGATTC
AGAACTCAGAT -> GAACTCAGATT
GAACTTACATG -> AACTTACATGG
AGAACTTACAT -> GAACTTACATG
GAAGAACGAAT -> AAGAACGAATC
AGAAGAACGAA -> GAAGAACGAAT
GAAGCCACCCA -> AAGCCACCCAT
GAATACCTCAA -> AATACCTCAAG
AGAATACCTCA -> GAATACCTCAA
GAATGCTGTGT -> AATGCTGTGTA
GAATGTCTGCC -> AATGTCTGCCC
GACAGTTCCCC -> ACAGTTCCCCC
AGACAGTTCCC -> GACAGTTCCCC
GACCAGCGCTA -> ACCAGCGCTAG
AGACCAGCGCT -> GACCAGCGCTA
GACCCTGTCCC -> ACCCTGTCCCC
GACCGGACACC -> ACCGGACACCC
AGACCGGACAC -> GACCGGACACC
GACCTCGTCAA -> ACCTCGTCAAG
AGACCTCGTCA -> GACCTCGTCAA
GACTCTTGCAA -> ACTCTTGCAAC
AGACTCTTGCA -> GACTCTTGCAA
GACTTTCGGGA -> ACTTTCGGGAA
AGACTTTCGGG -> GACTTTCGGGA
GAGAAACCGAC -> AGAAACCGACC
AGAGAAACCGA -> GAGAAACCGAC
GAGATCGAGAC -> AGATCGAGACC
AGAGATCGAGA -> GAGATCGAGAC
GAGGCATCAAA -> AGGCATCAAAC
AGAGGCATCAA -> GAGGCATCAAA
GAGGCGCTTCC -> AGGCGCTTCCG
AGAGGCGCTTC -> GAGGCGCTTCC
GAGGTAGATAT -> AGGTAGATATC
AGAGGTAGATA -> GAGGTAGATAT
GAGTACTTACT -> AGTACTTACTT
AGAGTACTTAC -> GAGTACTTACT
GAGTGAGTTGG -> AGTGAGTTGGG
AGAGTGAGTTG -> GAGTGAGTTGG
GATACGCCGGA -> ATACGCCGGAC
GATAGAGTGAG -> ATAGAGTGAGT
AGATAGAGTGA -> GATAGAGTGAG
GATATCGGCTT -> ATATCGGCTTA
AGATATCGGCT -> GATATCGGCTT
GATCGAGACCT -> ATCGAGACCTC
AGATCGAGACC -> GATCGAGACCT
GATCGTTACGT -> ATCGTTACGTT
AGATCGTTACG -> GATCGTTACGT
GATGACCGCGT -> ATGACCGCGTC
AGATGACCGCG -> GATGACCGCGT
GATGTCGTCAG -> ATGTCGTCAGA
GATTCGTTACC -> ATTCGTTACCC
AGATTCGTTAC -> GATTCGTTACC
GATTGCATTAA -> ATTGCATTAAT
AGATTGCATTA -> GATTGCATTAA
GCAAAGAAGCC -> CAAAGAAGCCA
AGCAAAGAAGC -> GCAAAGAAGCC
GCAACAAAATC -> CAACAAAATCG
AGCAACAAAAT -> GCAACAAAATC
GCACGTATTTA -> CACGTATTTAA
AGCACGTATTT -> GCACGTATTTA
GCACTGTGCGT -> CACTGTGCGTA
AGCACTGTGCG -> GCACTGTGCGT
GCAGCGGATTT -> CAGCGGATTTT
GCAGGCGCACG -> CAGGCGCACGA
AGCAGGCGCAC -> GCAGGCGCACG
GCCAACACAAC -> CCAACACAACT
AGCCAACACAA -> GCCAACACAAC
GCCAACATCTA -> CCAACATCTAC
AGCCAACATCT -> GCCAACATCTA
GCCAATTCAAT -> CCAATTCAATA
GCCACCCATAG -> CCACCCATAGG
GCCACGGGTAA -> CCACGGGTAAA
GCCATAGACTT -> CCATAGACTTT
GCCATCTGCAG -> CCATCTGCAGT
AGCCATCTGCA -> GCCATCTGCAG
GCCCCCCTAGA -> CCCCCCTAGAG
GCCCCCCTCTC -> CCCCCCTCTCG
AGCCCCCCTCT -> GCCCCCCTCTC
GCCCGGACCTC -> CCCGGACCTCG
AGCCCGGACCT -> GCCCGGACCTC
GCCTCAAGGTA -> CCTCAAGGTAG
AGCCTCAAGGT -> GCCTCAAGGTA
GCCTCTCCGCG -> CCTCTCCGCGC
GCCTGTTGTGT -> CCTGTTGTGTA
AGCCTGTTGTG -> GCCTGTTGTGT
GCCTTGCCCTT -> CCTTGCCCTTT
AGCCTTGCCCT -> GCCTTGCCCTT
GCGCGAACAGG -> CGCGAACAGGC
GCGCTAGCCCG -> CGCTAGCCCGG
AGCGCTAGCCC -> GCGCTAGCCCG
GCGGATTTTGT -> CGGATTTTGTG
AGCGGATTTTG -> GCGGATTTTGT
GCGTCGACCGA -> CGTCGACCGAA
AGCGTCGACCG -> GCGTCGACCGA
GCTCGCTGAGT -> CTCGCTGAGTC
AGCTCGCTGAG -> GCTCGCTGAGT
GCTGTTGCCCG -> CTGTTGCCCGT
GCTTAACCAAA -> CTTAACCAAAA
GCTTAACTGCG -> CTTAACTGCGT
AGCTTAACTGC -> GCTTAACTGCG
GCTTGCATTAC -> CTTGCATTACA
AGCTTGCATTA -> GCTTGCATTAC
GCTTTCAATAG -> CTTTCAATAGT
AGCTTTCAATA -> GCTTTCAATAG
GCTTTGAAGCC -> CTTTGAAGCCA
GCTTTGTCGCC -> CTTTGTCGCCA
AGCTTTGTCGC -> GCTTTGTCGCC
GGAATGCGGGG -> GAATGCGGGGA
AGGAATGCGGG -> GGAATGCGGGG
GGACAGCTTTG -> GACAGCTTTGT
AGGACAGCTTT -> GGACAGCTTTG
GGACCTCCTAG -> GACCTCCTAGG
GGACGAGACCA -> GACGAGACCAG
AGGACGAGACC -> GGACGAGACCA
GGACTGCATTA -> GACTGCATTAG
AGGACTGCATT -> GGACTGCATTA
GGAGATGACCG -> GAGATGACCGC
GGATAGCCATC -> GATAGCCATCT
AGGATAGCCAT -> GGATAGCCATC
GGATGGGAAGA -> GATGGGAAGAT
AGGATGGGAAG -> GGATGGGAAGA
GGCATCAAACA -> GCATCAAACAC
AGGCATCAAAC -> GGCATCAAACA
GGCATGGACAC -> GCATGGACACC
AGGCATGGACA -> GGCATGGACAC
GGCCCCACAAT -> GCCCCACAATT
AGGCCCCACAA -> GGCCCCACAAT
GGCCGTATTTC -> GCCGTATTTCC
AGGCCGTATTT -> GGCCGTATTTC
GGCGCACGACC -> GCGCACGACCG
AGGCGCACGAC -> GGCGCACGACC
GGCGCTTCCGG -> GCGCTTCCGGA
AGGCGCTTCCG -> GGCGCTTCCGG
GGCTGTCACAG -> GCTGTCACAGT
GGGAGGTAAGT -> GGAGGTAAGTC
AGGGAGGTAAG -> GGGAGGTAAGT
GGGCATCCTCT -> GGCATCCTCTC
GGGCTCAGCCT -> GGCTCAGCCTT
AGGGCTCAGCC -> GGGCTCAGCCT
GGGCTCGATGC -> GGCTCGATGCC
AGGGCTCGATG -> GGGCTCGATGC
GGGCTCTCAAC -> GGCTCTCAACT
AGGGCTCTCAA -> GGGCTCTCAAC
GGGGATAAGTG -> GGGATAAGTGC
GGTAAGTCGAA -> GTAAGTCGAAC
AGGTAAGTCGA -> GGTAAGTCGAA
GGTACAAGGGC -> GTACAAGGGCA
AGGTACAAGGG -> GGTACAAGGGC
GGTAGATATCG -> GTAGATATCGG
AGGTAGATATC -> GGTAGATATCG
GGTAGCACTGT -> GTAGCACTGTG
GGTGCACATGA -> GTGCACATGAA
GGTGGAGCCAA -> GTGGAGCCAAC
AGGTGGAGCCA -> GGTGGAGCCAA
GTAAACGCGTG -> TAAACGCGTGT
AGTAAACGCGT -> GTAAACGCGTG
GTAATACCCGG -> TAATACCCGGC
AGTAATACCCG -> GTAATACCCGG
GTAATTCACTA -> TAATTCACTAG
AGTAATTCACT -> GTAATTCACTA
GTACTCCAACA -> TACTCCAACAA
AGTACTCCAAC -> GTACTCCAACA
GTACTGAGGAC -> TACTGAGGACA
AGTACTGAGGA -> GTACTGAGGAC
GTACTTACTTA -> TACTTACTTAA
AGTACTTACTT -> GTACTTACTTA
GTAGTCTCTTC -> TAGTCTCTTCG
AGTAGTCTCTT -> GTAGTCTCTTC
GTATCGCATGA -> TATCGCATGAA
AGTATCGCATG -> GTATCGCATGA
GTCCAGGATGG -> TCCAGGATGGG
AGTCCAGGATG -> GTCCAGGATGG
GTCCGATTAGT -> TCCGATTAGTG
AGTCCGATTAG -> GTCCGATTAGT
GTCGAACCATG -> TCGAACCATGT
GTCGGTCCTGT -> TCGGTCCTGTG
AGTCGGTCCTG -> GTCGGTCCTGT
GTCTCCACATA -> TCTCCACATAA
AGTCTCCACAT -> GTCTCCACATA
GTCTCTTCGAA -> TCTCTTCGAAC
AGTCTCTTCGA -> GTCTCTTCGAA
GTCTGTCACTG -> TCTGTCACTGA
AGTCTGTCACT -> GTCTGTCACTG
GTGAGTTGGGC -> TGAGTTGGGCA
AGTGAGTTGGG -> GTGAGTTGGGC
GTGCGGTATCA -> TGCGGTATCAG
GTGCGGTGACT -> TGCGGTGACTT
GTGGAAATGTT -> TGGAAATGTTC
AGTGGAAATGT -> GTGGAAATGTT
GTTCCCCCCGA -> TTCCCCCCGAC
AGTTCCCCCCG -> GTTCCCCCCGA
GTTGGGCAACG -> TTGGGCAACGT
AGTTGGGCAAC -> GTTGGGCAACG
GTTGTGTAGGC -> TTGTGTAGGCA, TTGTGTAGGCC
GTTTACCTTTG -> TTTACCTTTGT
AGTTTACCTTT -> GTTTACCTTTG
GTTTCTCCGGA -> TTTCTCCGGAC
TAAAATTCCCG -> AAAATTCCCGA
ATAAAATTCCC -> TAAAATTCCCG
TAACCCTTGAG -> AACCCTTGAGT
ATAACCCTTGA -> TAACCCTTGAG
TAACTGTTGTG -> AACTGTTGTGA
ATAACTGTTGT -> TAACTGTTGTG
TAAGTGCGGTA -> AAGTGCGGTAT
ATAAGTGCGGT -> TAAGTGCGGTA
TAATGGTGAAT -> AATGGTGAATC
ATAATGGTGAA -> TAATGGTGAAT
TACATAGGTAC -> ACATAGGTACA
ATACATAGGTA -> TACATAGGTAC
TACCCGGCATT -> ACCCGGCATTT
TACCTAGGTGG -> ACCTAGGTGGA
ATACCTAGGTG -> TACCTAGGTGG
TACCTCAAGGA -> ACCTCAAGGAC
TACGATGAATC -> ACGATGAATCT
ATACGATGAAT -> TACGATGAATC
TACGCCGGACG -> ACGCCGGACGA
ATACGCCGGAC -> TACGCCGGACG
TACTCCGATTC -> ACTCCGATTCT
TACTGATTTTG -> ACTGATTTTGG
ATACTGATTTT -> TACTGATTTTG
TACTTTGATTT -> ACTTTGATTTG
ATACTTTGATT -> TACTTTGATTT
TAGACTTTCGG -> AGACTTTCGGG
ATAGACTTTCG -> TAGACTTTCGG
TAGAGAAACCG -> AGAGAAACCGA
TAGAGTGAGTT -> AGAGTGAGTTG
ATAGAGTGAGT -> TAGAGTGAGTT
TAGCCATCTGC -> AGCCATCTGCA
ATAGCCATCTG -> TAGCCATCTGC
TAGCGTCGACC -> AGCGTCGACCG
ATAGCGTCGAC -> TAGCGTCGACC
TAGCTTTCAAT -> AGCTTTCAATA
TAGGACTGCAT -> AGGACTGCATT
ATAGGACTGCA -> TAGGACTGCAT
TAGGGCTCAGC -> AGGGCTCAGCC
ATAGGGCTCAG -> TAGGGCTCAGC
TAGGTACAAGG -> AGGTACAAGGG
ATAGGTACAAG -> TAGGTACAAGG
TAGTACTGAGG -> AGTACTGAGGA
ATAGTACTGAG -> TAGTACTGAGG
TAGTCGGTCCT -> AGTCGGTCCTG
TATAACCCTTG -> ATAACCCTTGA
ATATAACCCTT -> TATAACCCTTG
TATATCGACCA -> ATATCGACCAT
ATATATCGACC -> TATATCGACCA
TATCGACCATG -> ATCGACCATGT
ATATCGACCAT -> TATCGACCATG
TATCGGCTTAA -> ATCGGCTTAAA
ATATCGGCTTA -> TATCGGCTTAA
TATGACGGAGC -> ATGACGGAGCC
ATATGACGGAG -> TATGACGGAGC
TATGGTCTGGA -> ATGGTCTGGAG
ATATGGTCTGG -> TATGGTCTGGA
TATTGCGTAGA -> ATTGCGTAGAT
ATATTGCGTAG -> TATTGCGTAGA
TCAAACACTAC -> CAAACACTACT
ATCAAACACTA -> TCAAACACTAC
TCAATTCTGGG -> CAATTCTGGGG
TCAGAACGAAC -> CAGAACGAACC
ATCAGAACGAA -> TCAGAACGAAC
TCATACTGATT -> CATACTGATTT
ATCATACTGAT -> TCATACTGATT
TCATATATCGA -> CATATATCGAC
ATCATATATCG -> TCATATATCGA
TCCGCGCATAA -> CCGCGCATAAC
ATCCGCGCATA -> TCCGCGCATAA
TCCTCTCGGAG -> CCTCTCGGAGA
ATCCTCTCGGA -> TCCTCTCGGAG
TCCTTGGCCCT -> CCTTGGCCCTC
ATCCTTGGCCC -> TCCTTGGCCCT
TCGACCATGTA -> CGACCATGTAA
ATCGACCATGT -> TCGACCATGTA
TCGAGACCTCG -> CGAGACCTCGT
ATCGAGACCTC -> TCGAGACCTCG
TCGCATCCGCG -> CGCATCCGCGC
ATCGCATCCGC -> TCGCATCCGCG
TCGCATGAACT -> CGCATGAACTG
ATCGCATGAAC -> TCGCATGAACT
TCGGATACATA -> CGGATACATAG
TCGGCCGGATG -> CGGCCGGATGC
TCGGCTTAAAC -> CGGCTTAAACT
ATCGGCTTAAA -> TCGGCTTAAAC
TCGGTCCTAGT -> CGGTCCTAGTA
TCGGTTAGGGA -> CGGTTAGGGAG
ATCGGTTAGGG -> TCGGTTAGGGA
TCGTTACGTTA -> CGTTACGTTAA
ATCGTTACGTT -> TCGTTACGTTA
TCTACTCCGAT -> CTACTCCGATA
ATCTACTCCGA -> TCTACTCCGAT
TCTCCTTCTCA -> CTCCTTCTCAT
TCTCGTCTTTT -> CTCGTCTTTTT
TCTGAACCAGA -> CTGAACCAGAA
TCTGCAGTATC -> CTGCAGTATCG
ATCTGCAGTAT -> TCTGCAGTATC
TCTGCTTGATT -> CTGCTTGATTA
ATCTGCTTGAT -> TCTGCTTGATT
TGAACTGACGG -> GAACTGACGGT
ATGAACTGACG -> TGAACTGACGG
TGAATAGCTTT -> GAATAGCTTTC
ATGAATAGCTT -> TGAATAGCTTT
TGAATCTGAAC -> GAATCTGAACC
ATGAATCTGAA -> TGAATCTGAAC
TGACCGCGTCA -> GACCGCGTCAC
ATGACCGCGTC -> TGACCGCGTCA
TGACGGAGCCA -> GACGGAGCCAA
ATGACGGAGCC -> TGACGGAGCCA
TGACGGCCTCT -> GACGGCCTCTA
TGATTTCCTAG -> GATTTCCTAGC
ATGATTTCCTA -> TGATTTCCTAG
TGCAACTACGT -> GCAACTACGTT
ATGCAACTACG -> TGCAACTACGT
TGCACGCTCTC -> GCACGCTCTCG
ATGCACGCTCT -> TGCACGCTCTC
TGCCGACACTT -> GCCGACACTTT
ATGCCGACACT -> TGCCGACACTT
TGCCTGCCCTC -> GCCTGCCCTCT
ATGCCTGCCCT -> TGCCTGCCCTC
TGCGAGAGGCA -> GCGAGAGGCAT
ATGCGAGAGGC -> TGCGAGAGGCA
TGCGATGCACG -> GCGATGCACGC
ATGCGATGCAC -> TGCGATGCACG
TGCGGGGATTC -> GCGGGGATTCT
TGCTACCAACA -> GCTACCAACAC
TGCTGTGTAGA -> GCTGTGTAGAT
TGGACACCGCG -> GGACACCGCGG
ATGGACACCGC -> TGGACACCGCG
TGGAGCCCCCC -> GGAGCCCCCCT
ATGGAGCCCCC -> TGGAGCCCCCC
TGGGAAGATGT -> GGGAAGATGTC
ATGGGAAGATG -> TGGGAAGATGT
TGGGAGGGCTC -> GGGAGGGCTCG
ATGGGAGGGCT -> TGGGAGGGCTC
TGGTAGTCTCC -> GGTAGTCTCCA
ATGGTAGTCTC -> TGGTAGTCTCC
TGGTCCGAAGC -> GGTCCGAAGCC
ATGGTCCGAAG -> TGGTCCGAAGC
TGGTCTGGAGG -> GGTCTGGAGGA
ATGGTCTGGAG -> TGGTCTGGAGG
TGGTGAAGACC -> GGTGAAGACCC
ATGGTGAAGAC -> TGGTGAAGACC
TGGTGAATCGG -> GGTGAATCGGA
TGTAAGCCACG -> GTAAGCCACGG
ATGTAAGCCAC -> TGTAAGCCACG
TGTACTGTCTT -> GTACTGTCTTG
ATGTACTGTCT -> TGTACTGTCTT
TGTCGTCAGAT -> GTCGTCAGATC
ATGTCGTCAGA -> TGTCGTCAGAT
TGTCTCCGCTC -> GTCTCCGCTCC
ATGTCTCCGCT -> TGTCTCCGCTC
TGTCTGCCCGA -> GTCTGCCCGAC
TGTGCTGTTAG -> GTGCTGTTAGT
TGTTATGGTAG -> GTTATGGTAGT
ATGTTATGGTA -> TGTTATGGTAG
TGTTCGGGCCG -> GTTCGGGCCGA
TGTTTTAACAT -> GTTTTAACATC
ATGTTTTAACA -> TGTTTTAACAT
TTAAAAGAATG -> TAAAAGAATGT
ATTAAAAGAAT -> TTAAAAGAATG
TTAATGTGCTG -> TAATGTGCTGT
ATTAATGTGCT -> TTAATGTGCTG
TTACAACCTCC -> TACAACCTCCG
ATTACAACCTC -> TTACAACCTCC
TTACCAGCAAA -> TACCAGCAAAG
ATTACCAGCAA -> TTACCAGCAAA
TTAGAAGAACG -> TAGAAGAACGA
ATTAGAAGAAC -> TTAGAAGAACG
TTAGTGGAAAT -> TAGTGGAAATG
ATTAGTGGAAA -> TTAGTGGAAAT
TTCAAGCCCCC -> TCAAGCCCCCC
ATTCAAGCCCC -> TTCAAGCCCCC
TTCAATAGAGA -> TCAATAGAGAA
TTCAATGACGG -> TCAATGACGGC
ATTCAATGACG -> TTCAATGACGG
TTCACTAGCAA -> TCACTAGCAAC
TTCCCGATATG -> TCCCGATATGG
TTCCTACCCCG -> TCCTACCCCGG
ATTCCTACCCC -> TTCCTACCCCG
TTCGTTACCCT -> TCGTTACCCTC
ATTCGTTACCC -> TTCGTTACCCT
TTCTAAAAGGA -> TCTAAAAGGAG
ATTCTAAAAGG -> TTCTAAAAGGA
TTCTCGTTCGT -> TCTCGTTCGTG
ATTCTCGTTCG -> TTCTCGTTCGT
TTCTGGCGATA -> TCTGGCGATAC
TTCTGGGGTGT -> TCTGGGGTGTT
TTGCATTAATG -> TGCATTAATGT
ATTGCATTAAT -> TTGCATTAATG
TTGCGTAGATT -> TGCGTAGATTG
ATTGCGTAGAT -> TTGCGTAGATT
TTGGCCTAGAC -> TGGCCTAGACA
ATTGGCCTAGA -> TTGGCCTAGAC
TTGGTACATGT -> TGGTACATGTT
ATTGGTACATG -> TTGGTACATGT
TTTAAGCGCGA -> TTAAGCGCGAA
ATTTAAGCGCG -> TTTAAGCGCGA
TTTAAGGTGCA -> TTAAGGTGCAC
ATTTAAGGTGC -> TTTAAGGTGCA
TTTCCAAGGGG -> TTCCAAGGGGA
TTTCCCGGGAC -> TTCCCGGGACT
ATTTCCCGGGA -> TTTCCCGGGAC
TTTCCTAGCTT -> TTCCTAGCTTG
ATTTCCTAGCT -> TTTCCTAGCTT
TTTCCTGGTGG -> TTCCTGGTGGA
TTTGAGAAAGA -> TTGAGAAAGAA
ATTTGAGAAAG -> TTTGAGAAAGA
TTTTGGGTAGA -> TTTGGGTAGAC
ATTTTGGGTAG -> TTTTGGGTAGA
TTTTGTGATAT -> TTTGTGATATA
ATTTTGTGATA -> TTTTGTGATAT
CAAAACGCATA -> AAAACGCATAG
CAAACACTACT -> AAACACTACTT
CAAAGAAGCCA -> AAAGAAGCCAC
CAACAAAATCG -> AACAAAATCGG
CAACAAGCCTC -> AACAAGCCTCT
CAACACAACTG -> AACACAACTGG
CAACACCGCAT -> AACACCGCATG
CAACATCTACT -> AACATCTACTC
CAACGTAACCA -> AACGTAACCAT
CAACTACGTTG -> AACTACGTTGC
CAACTATGCGA -> AACTATGCGAT
CAACTTGATGG -> AACTTGATGGT
CAACTTGTTAA -> AACTTGTTAAA
CAAGCCCCCCT -> AAGCCCCCCTA
CAAGCTTTGAA -> AAGCTTTGAAG
CAAGGACCTCC -> AAGGACCTCCT
CAAGGGGATAA -> AAGGGGATAAG
CAAGGTAGCAC -> AAGGTAGCACT
CAATACTCCGA -> AATACTCCGAT
CAATAGAGAAA -> AATAGAGAAAC
CAATAGTCGGT -> AATAGTCGGTC
CAATGACGGCC -> AATGACGGCCT
CAATTCAATAG -> AATTCAATAGA
CAATTCTGGGG -> AATTCTGGGGT
CACAATTTCCT -> ACAATTTCCTG
CACAGTCTGTC -> ACAGTCTGTCA
CACATAAAATT -> ACATAAAATTC
CACATGAATAG -> ACATGAATAGC
CACCACTAATC -> ACCACTAATCG
CACCATATGAC -> ACCATATGACG
CACCCATAGGG -> ACCCATAGGGC
CACCGCAGAGA -> ACCGCAGAGAT
CACCGTATGGA -> ACCGTATGGAG
CACGACCGTTC -> ACGACCGTTCT
CACGCTCTCGA -> ACGCTCTCGAT
CACGGGTAAAC -> ACGGGTAAACC
CACGGGTAATC -> ACGGGTAATCA
CACGTATTTAA -> ACGTATTTAAG
CACGTTGTATA -> ACGTTGTATAG
CACTAATCGGC -> ACTAATCGGCC
CACTAGCAACA -> ACTAGCAACAA
CACTGAACTCT -> ACTGAACTCTC
CACTGCTATCT -> ACTGCTATCTG
CACTGTGCGTA -> ACTGTGCGTAA
CAGAACGAACC -> AGAACGAACCC
CAGAACTTACA -> AGAACTTACAT
CAGAGATCGAG -> AGAGATCGAGA
CAGATCGTTAC -> AGATCGTTACG
CAGATTCGTTA -> AGATTCGTTAC
CAGCAAAGAAG -> AGCAAAGAAGC
CAGCCTTGCCC -> AGCCTTGCCCT
CAGCGCTAGCC -> AGCGCTAGCCC
CAGCGGATTTT -> AGCGGATTTTG
CAGCTCGCTGA -> AGCTCGCTGAG
CAGGATGGGAA -> AGGATGGGAAG
CAGGCGCACGA -> AGGCGCACGAC
CAGTAATACCC -> AGTAATACCCG
CAGTATCGCAT -> AGTATCGCATG
CATAACTGTTG -> ATAACTGTTGT
CATACTGATTT -> ATACTGATTTT
CATAGACTTTC -> ATAGACTTTCG
CATAGCGTCGA -> ATAGCGTCGAC
CATAGGGCTCA -> ATAGGGCTCAG
CATATATCGAC -> ATATATCGACC
CATATGACGGA -> ATATGACGGAG
CATCAAACACT -> ATCAAACACTA
CATCCGCGCAT -> ATCCGCGCATA
CATCCTCTCGG -> ATCCTCTCGGA
CATCCTTGGCC -> ATCCTTGGCCC
CATCTGCAGTA -> ATCTGCAGTAT
CATGAACTGAC -> ATGAACTGACG
CATGCCTGCCC -> ATGCCTGCCCT
CATGGACACCG -> ATGGACACCGC
CATGTAAGCCA -> ATGTAAGCCAC
CATGTCTCCGC -> ATGTCTCCGCT
CATTAATGTGC -> ATTAATGTGCT
CATTACAACCT -> ATTACAACCTC
CATTAGAAGAA -> ATTAGAAGAAC
CATTCAATGAC -> ATTCAATGACG
CATTGGTACAT -> ATTGGTACATG
CATTTAAGCGC -> ATTTAAGCGCG
CCAACAAGCCT -> CAACAAGCCTC
CCAACACAACT -> CAACACAACTG
CCAACATCTAC -> CAACATCTACT
CCAACTTGTTA -> CAACTTGTTAA
CCAAGGGGATA -> CAAGGGGATAA
CCAATTCAATA -> CAATTCAATAG
CCACAATTTCC -> CACAATTTCCT
CCACATAAAAT -> CACATAAAATT
CCACCATATGA -> CACCATATGAC
CCACCCATAGG -> CACCCATAGGG
CCACCGTATGG -> CACCGTATGGA
CCACGGGTAAA -> CACGGGTAAAC
CCAGGATGGGA -> CAGGATGGGAA
CCAGTAATACC -> CAGTAATACCC
CCATAGACTTT -> CATAGACTTTC
CCATAGGGCTC -> CATAGGGCTCA
CCATCTGCAGT -> CATCTGCAGTA
CCCACAATTTC -> CCACAATTTCC
CCCCACAATTT -> CCCACAATTTC
CCCCCGACTAG -> CCCCGACTAGC
CCCCCCGACTA -> CCCCCGACTAG
CCCCCTAGAGT -> CCCCTAGAGTA
CCCCCCTAGAG -> CCCCCTAGAGT
CCCCCTCTCGT -> CCCCTCTCGTC
CCCCCCTCTCG -> CCCCCTCTCGT
CCCCGACTAGC -> CCCGACTAGCT
CCCCTAGAGTA -> CCCTAGAGTAC
CCCCTCTCGTC -> CCCTCTCGTCC
CCCGACTAGCT -> CCGACTAGCTT
CCCGGTAATGC -> CCGGTAATGCT
CCCCGGTAATG -> CCCGGTAATGC
CCCGGTGCGAC -> CCGGTGCGACA
CCCTAGAGTAC -> CCTAGAGTACT
CCCTATGGGAG -> CCTATGGGAGG
CCCTCTCGTCC -> CCTCTCGTCCG
CCCTTTAAGCT -> CCTTTAAGCTT
CCGACCTAAGT -> CGACCTAAGTT
CCCGACCTAAG -> CCGACCTAAGT
CCGACTAGCTT -> CGACTAGCTTA
CCGATATGGTC -> CGATATGGTCT
CCCGATATGGT -> CCGATATGGTC
CCGCAGCTCGC -> CGCAGCTCGCT
CCCGCAGCTCG -> CCGCAGCTCGC
CCGCTTGACAG -> CGCTTGACAGT
CCGGACCTCGA -> CGGACCTCGAT
CCCGGACCTCG -> CCGGACCTCGA
CCGGCATTTAA -> CGGCATTTAAG
CCGGGACTTGA -> CGGGACTTGAT
CCCGGGACTTG -> CCGGGACTTGA
CCGGTAATGCT -> CGGTAATGCTA
CCGGTGCGACA -> CGGTGCGACAG
CCGTGCTCCGG -> CGTGCTCCGGA
CCCGTGCTCCG -> CCGTGCTCCGG
CCGTGGATACT -> CGTGGATACTT
CCTAGAGTACT -> CTAGAGTACTT
CCTATGGGAGG -> CTATGGGAGGG
CCTCGACCCCT -> CTCGACCCCTA
CCTCGGCGTTT -> CTCGGCGTTTT
CCCTCGGCGTT -> CCTCGGCGTTT
CCTCTCAATAC -> CTCTCAATACT
CCCTCTCAATA -> CCTCTCAATAC
CCTCTCGTCCG -> CTCTCGTCCGT
CCTGTCCCCGG -> CTGTCCCCGGT
CCTTGAGTAGT -> CTTGAGTAGTC
CCTTTAAGCTT -> CTTTAAGCTTA
CCTTTAGAACT -> CTTTAGAACTC
CCCTTTAGAAC -> CCTTTAGAACT
CGAAGCAGCGG -> GAAGCAGCGGA
CGAAGCCAATT -> GAAGCCAATTC
CCGAAGCCAAT -> CGAAGCCAATT
CGACACTTTCC -> GACACTTTCCA
CCGACACTTTC -> CGACACTTTCC
CGACCCACCGT -> GACCCACCGTA
CGACCTAAGTT -> GACCTAAGTTT
CGACTAGCTTA -> GACTAGCTTAA
CGATATGGTCT -> GATATGGTCTG
CGATATTGCGT -> GATATTGCGTA
CCGATATTGCG -> CGATATTGCGT
CGATGTACTGT -> GATGTACTGTC
CCGATGTACTG -> CGATGTACTGT
CGATTAGTGGA -> GATTAGTGGAA
CCGATTAGTGG -> CGATTAGTGGA
CGATTCTAAAA -> GATTCTAAAAG
CCGATTCTAAA -> CGATTCTAAAA
CGCAGAGATCG -> GCAGAGATCGA
CGCAGCTCGCT -> GCAGCTCGCTG
CGCATGCCTGC -> GCATGCCTGCC
CGCGCATAACT -> GCGCATAACTG
CCGCGCATAAC -> CGCGCATAACT
CGCGCTAGGGC -> GCGCTAGGGCT
CCGCGCTAGGG -> CGCGCTAGGGC
CGCGGTCACCA -> GCGGTCACCAC
CGCGTCACTGC -> GCGTCACTGCT
CGCTCCCGCAG -> GCTCCCGCAGC
CCGCTCCCGCA -> CGCTCCCGCAG
CGCTGTTGAGT -> GCTGTTGAGTT
CGCTTGACAGT -> GCTTGACAGTA
CGGAAAGTGCG -> GGAAAGTGCGG
CCGGAAAGTGC -> CGGAAAGTGCG
CGGAATTCTGG -> GGAATTCTGGC
CCGGAATTCTG -> CGGAATTCTGG
CGGACAACACC -> GGACAACACCG
CCGGACAACAC -> CGGACAACACC
CGGACACCCGC -> GGACACCCGCT
CGGACCTCGAT -> GGACCTCGATA
CGGACGACTTT -> GGACGACTTTA
CCGGACGACTT -> CGGACGACTTT
CGGACGTGGAT -> GGACGTGGATC
CCGGACGTGGA -> CGGACGTGGAT
CGGATGCAACT -> GGATGCAACTA
CCGGATGCAAC -> CGGATGCAACT
CGGCATTTAAG -> GGCATTTAAGC
CGGGACTTGAT -> GGGACTTGATT
CGGTAATGCTA -> GGTAATGCTAC
CGGTGCGACAG -> GGTGCGACAGC
CGTATACCTAG -> GTATACCTAGG
CCGTATACCTA -> CGTATACCTAG
CGTATGGAGCC -> GTATGGAGCCC
CGTATTTCCCG -> GTATTTCCCGG
CCGTATTTCCC -> CGTATTTCCCG
CGTGCTCCGGA -> GTGCTCCGGAA
CGTGGATACTT -> GTGGATACTTT
CGTTCTTTAGG -> GTTCTTTAGGA
CTAAGTTTCTC -> TAAGTTTCTCC
CTAATCTCCTT -> TAATCTCCTTC
CCTAATCTCCT -> CTAATCTCCTT
CTACCCCGGTG -> TACCCCGGTGC
CCTACCCCGGT -> CTACCCCGGTG
CTAGACAGTTC -> TAGACAGTTCC
CCTAGACAGTT -> CTAGACAGTTC
CTAGAGTACTT -> TAGAGTACTTA
CTAGCTTGCAT -> TAGCTTGCATT
CCTAGCTTGCA -> CTAGCTTGCAT
CTAGGATAGCC -> TAGGATAGCCA
CCTAGGATAGC -> CTAGGATAGCC
CTAGGTGGAGC -> TAGGTGGAGCC
CTAGTAAACGC -> TAGTAAACGCG
CCTAGTAAACG -> CTAGTAAACGC
CTATGGGAGGG -> TATGGGAGGGC
CTCAAGGACCT -> TCAAGGACCTC
CTCAAGGTAGC -> TCAAGGTAGCA
CCTCAAGGTAG -> CTCAAGGTAGC
CTCCAGTAATA -> TCCAGTAATAC
CTCCGGACAAC -> TCCGGACAACA
CTCCTAGGATA -> TCCTAGGATAG
CTCGACCCCTA -> TCGACCCCTAT
CTCGATAGGAC -> TCGATAGGACT
CTCGGCGTTTT -> TCGGCGTTTTA
CTCGTCAAGCT -> TCGTCAAGCTT
CTCTACAGAGG -> TCTACAGAGGT
CCTCTACAGAG -> CTCTACAGAGG
CTCTCAATACT -> TCTCAATACTC
CTCTCCGCGCT -> TCTCCGCGCTA
CCTCTCCGCGC -> CTCTCCGCGCT
CTCTCGGAGAC -> TCTCGGAGACC
CCTCTCGGAGA -> CTCTCGGAGAC
CTCTCGTCCGT -> TCTCGTCCGTA
CTGCCCTCTCA -> TGCCCTCTCAA
CCTGCCCTCTC -> CTGCCCTCTCA
CTGGTGGATGA -> TGGTGGATGAT
CCTGGTGGATG -> CTGGTGGATGA
CTGTCCCCGGT -> TGTCCCCGGTA
CTGTGTGAGAA -> TGTGTGAGAAT
CCTGTGTGAGA -> CTGTGTGAGAA
CTGTTGTGTAG -> TGTTGTGTAGG
CCTGTTGTGTA -> CTGTTGTGTAG
CTTCTCATCCT -> TTCTCATCCTT
CCTTCTCATCC -> CTTCTCATCCT
CTTGAGTAGTC -> TTGAGTAGTCT
CTTGCCCTTTA -> TTGCCCTTTAG
CCTTGCCCTTT -> CTTGCCCTTTA
CTTGGCCCTCG -> TTGGCCCTCGG
CCTTGGCCCTC -> CTTGGCCCTCG
CTTGGCGTAGC -> TTGGCGTAGCC
CTTTAAGCTTA -> TTTAAGCTTAA
CTTTAGAACTC -> TTTAGAACTCA
CTTTGTCGATT -> TTTGTCGATTA
GAACAGGCCGT -> AACAGGCCGTA
CGAACAGGCCG -> GAACAGGCCGT
GAACCACGTTG -> AACCACGTTGT
CGAACCACGTT -> GAACCACGTTG
GAACCATGTCT -> AACCATGTCTC
CGAACCATGTC -> GAACCATGTCT
GAACCCGTGGA -> AACCCGTGGAT
GAAGCAGCGGA -> AAGCAGCGGAT
GAAGCCAATTC -> AAGCCAATTCA
GAAGTTGTGTA -> AAGTTGTGTAG
CGAAGTTGTGT -> GAAGTTGTGTA
GAATCTCGTCT -> AATCTCGTCTT
GACACTTTCCA -> ACACTTTCCAC
GACAGCAGGCG -> ACAGCAGGCGC
CGACAGCAGGC -> GACAGCAGGCG
GACCATGTAAG -> ACCATGTAAGC
CGACCATGTAA -> GACCATGTAAG
GACCCACCGTA -> ACCCACCGTAT
GACCCCTATGG -> ACCCCTATGGG
CGACCCCTATG -> GACCCCTATGG
GACCGAAGCAG -> ACCGAAGCAGC
CGACCGAAGCA -> GACCGAAGCAG
GACCGTTCTTT -> ACCGTTCTTTA
GACCTAAGTTT -> ACCTAAGTTTC
GACTAGCTTAA -> ACTAGCTTAAC
GACTTTACTGA -> ACTTTACTGAT
GAGACCAGCGC -> AGACCAGCGCT
GAGACCTCGTC -> AGACCTCGTCA
CGAGACCTCGT -> GAGACCTCGTC
GAGAGGCATCA -> AGAGGCATCAA
CGAGAGGCATC -> GAGAGGCATCA
GATACGATGAA -> ATACGATGAAT
CGATACGATGA -> GATACGATGAA
GATAGGACTGC -> ATAGGACTGCA
CGATAGGACTG -> GATAGGACTGC
GATATGGTCTG -> ATATGGTCTGG
GATATTGCGTA -> ATATTGCGTAG
GATCATACTGA -> ATCATACTGAT
GATGAATCTGA -> ATGAATCTGAA
GATGCACGCTC -> ATGCACGCTCT
CGATGCACGCT -> GATGCACGCTC
GATGCCGACAC -> ATGCCGACACT
CGATGCCGACA -> GATGCCGACAC
GATGCGAGAGG -> ATGCGAGAGGC
CGATGCGAGAG -> GATGCGAGAGG
GATGTACTGTC -> ATGTACTGTCT
GATTACCAGCA -> ATTACCAGCAA
CGATTACCAGC -> GATTACCAGCA
GATTAGTGGAA -> ATTAGTGGAAA
GATTCTAAAAG -> ATTCTAAAAGG
GCACGACCGTT -> CACGACCGTTC
CGCACGACCGT -> GCACGACCGTT
GCAGAGATCGA -> CAGAGATCGAG
GCAGCTCGCTG -> CAGCTCGCTGA
GCATAACTGTT -> CATAACTGTTG
CGCATAACTGT -> GCATAACTGTT
GCATAGCGTCG -> CATAGCGTCGA
GCATCCGCGCA -> CATCCGCGCAT
CGCATCCGCGC -> GCATCCGCGCA
GCATGAACTGA -> CATGAACTGAC
CGCATGAACTG -> GCATGAACTGA
GCATGCCTGCC -> CATGCCTGCCC
GCCAACTTGTT -> CCAACTTGTTA
CGCCAACTTGT -> GCCAACTTGTT
GCCGGACGACT -> CCGGACGACTT
GCCTAATCTCC -> CCTAATCTCCT
CGCCTAATCTC -> GCCTAATCTCC
GCGAACAGGCC -> CGAACAGGCCG
CGCGAACAGGC -> GCGAACAGGCC
GCGCATAACTG -> CGCATAACTGT
GCGCTAGGGCT -> CGCTAGGGCTC
GCGGTCACCAC -> CGGTCACCACT
GCGGTTCTCAC -> CGGTTCTCACC
CGCGGTTCTCA -> GCGGTTCTCAC
GCGTCACTGCT -> CGTCACTGCTA
GCGTGTGTCGC -> CGTGTGTCGCG
GCTACCTTGGC -> CTACCTTGGCG
CGCTACCTTGG -> GCTACCTTGGC
GCTAGCCCGGA -> CTAGCCCGGAC
CGCTAGCCCGG -> GCTAGCCCGGA
GCTAGGGCTCT -> CTAGGGCTCTC
CGCTAGGGCTC -> GCTAGGGCTCT
GCTCCCGCAGC -> CTCCCGCAGCT
GCTCTCGATGC -> CTCTCGATGCG
GCTGAGTCCGA -> CTGAGTCCGAT
CGCTGAGTCCG -> GCTGAGTCCGA
GCTGTTGAGTT -> CTGTTGAGTTT
GCTTCCGGAAT -> CTTCCGGAATT
CGCTTCCGGAA -> GCTTCCGGAAT
GCTTGACAGTA -> CTTGACAGTAA
GGAAAGTGCGG -> GAAAGTGCGGT
GGAATTCTGGC -> GAATTCTGGCG
GGACAACACCG -> GACAACACCGC
GGACACCCGCT -> GACACCCGCTT
GGACCTCGATA -> GACCTCGATAG
GGACGACTTTA -> GACGACTTTAC
GGACGTGGATC -> GACGTGGATCG
GGAGACCGGAC -> GAGACCGGACA
CGGAGACCGGA -> GGAGACCGGAC
GGAGCCAACAC -> GAGCCAACACA
GGATACATAGG -> GATACATAGGT
CGGATACATAG -> GGATACATAGG
GGATGCAACTA -> GATGCAACTAC
GGATTTTGTGA -> GATTTTGTGAT
CGGATTTTGTG -> GGATTTTGTGA
GGCATTTAAGC -> GCATTTAAGCG
GGCCGGATGCA -> GCCGGATGCAA
CGGCCGGATGC -> GGCCGGATGCA
GGCCTCTACAG -> GCCTCTACAGA
GGCGTTTTAAG -> GCGTTTTAAGC
CGGCGTTTTAA -> GGCGTTTTAAG
GGCTTAAACTG -> GCTTAAACTGC
CGGCTTAAACT -> GGCTTAAACTG
GGGAAACCTCC -> GGAAACCTCCA
CGGGAAACCTC -> GGGAAACCTCC
GGGACTTGATT -> GGACTTGATTC
GGGCCGATGTA -> GGCCGATGTAC
CGGGCCGATGT -> GGGCCGATGTA
GGGGATTCTCG -> GGGATTCTCGT
CGGGGATTCTC -> GGGGATTCTCG
GGGTAAACCCC -> GGTAAACCCCA
GGGTAATCAAT -> GGTAATCAATT
GGTAATGCTAC -> GTAATGCTACC
GGTATCAGAAC -> GTATCAGAACG
CGGTATCAGAA -> GGTATCAGAAC
GGTCACCACTA -> GTCACCACTAA
CGGTCACCACT -> GGTCACCACTA
GGTCCTAGTAA -> GTCCTAGTAAA
CGGTCCTAGTA -> GGTCCTAGTAA
GGTCCTGTGTG -> GTCCTGTGTGA
CGGTCCTGTGT -> GGTCCTGTGTG
GGTCTCGCCTA -> GTCTCGCCTAA
GGTGACTTGCG -> GTGACTTGCGT
CGGTGACTTGC -> GGTGACTTGCG
GGTGCGACAGC -> GTGCGACAGCA
GGTTAGGGAGG -> GTTAGGGAGGT
CGGTTAGGGAG -> GGTTAGGGAGG
GGTTCTCACCG -> GTTCTCACCGC
CGGTTCTCACC -> GGTTCTCACCG
GTAACCATTCA -> TAACCATTCAA
GTAAGGCTGTC -> TAAGGCTGTCA
CGTAAGGCTGT -> GTAAGGCTGTC
GTAGATTGCAT -> TAGATTGCATT
CGTAGATTGCA -> GTAGATTGCAT
GTAGCCTGTTG -> TAGCCTGTTGT
CGTAGCCTGTT -> GTAGCCTGTTG
GTATAATGGTG -> TATAATGGTGA
CGTATAATGGT -> GTATAATGGTG
GTATACCTAGG -> TATACCTAGGT
GTATGGAGCCC -> TATGGAGCCCC
GTATTTAAGGT -> TATTTAAGGTG
GTATTTCCCGG -> TATTTCCCGGG
GTCAAGCTTTG -> TCAAGCTTTGA
CGTCAAGCTTT -> GTCAAGCTTTG
GTCACTGCTAT -> TCACTGCTATC
CGTCACTGCTA -> GTCACTGCTAT
GTCAGATCGTT -> TCAGATCGTTA
CGTCAGATCGT -> GTCAGATCGTT
GTCCGTATACC -> TCCGTATACCT
CGTCCGTATAC -> GTCCGTATACC
GTCGACCGAAG -> TCGACCGAAGC
CGTCGACCGAA -> GTCGACCGAAG
GTCTAGCCTCA -> TCTAGCCTCAA
CGTCTAGCCTC -> GTCTAGCCTCA
GTCTTTTTTAA -> TCTTTTTTAAC
CGTCTTTTTTA -> GTCTTTTTTAA
GTGCTCCGGAA -> TGCTCCGGAAA
GTGCTGTTCGT -> TGCTGTTCGTA
CGTGCTGTTCG -> GTGCTGTTCGT
GTGGAAGATAC -> TGGAAGATACG
CGTGGAAGATA -> GTGGAAGATAC
GTGGATACTTT -> TGGATACTTTG
GTGGATCGCAT -> TGGATCGCATC
GTGTGTCGCGG -> TGTGTCGCGGT
CGTGTGTCGCG -> GTGTGTCGCGG
GTTAAATTTCC -> TTAAATTTCCA
GTTACCCTCGA -> TTACCCTCGAC
CGTTACCCTCG -> GTTACCCTCGA
GTTACGTTAAA -> TTACGTTAAAT
CGTTACGTTAA -> GTTACGTTAAA
GTTCGTGCTGT -> TTCGTGCTGTT
CGTTCGTGCTG -> GTTCGTGCTGT
GTTCTTTAGGA -> TTCTTTAGGAA
GTTGCTACAGA -> TTGCTACAGAG
GTTGTATAGTA -> TTGTATAGTAC
GTTTTAAGCTG -> TTTTAAGCTGT
CGTTTTAAGCT -> GTTTTAAGCTG
TAAAAGGAGAT -> AAAAGGAGATG
CTAAAAGGAGA -> TAAAAGGAGAT
TAAGTTTCTCC -> AAGTTTCTCCG
TAATCGGCCGG -> AATCGGCCGGA
TAATCTCCTTC -> AATCTCCTTCT
TACAGAGGCGC -> ACAGAGGCGCT
CTACAGAGGCG -> TACAGAGGCGC
TACAGAGGTAG -> ACAGAGGTAGA
CTACAGAGGTA -> TACAGAGGTAG
TACCAACACCG -> ACCAACACCGC
CTACCAACACC -> TACCAACACCG
TACCCCGGTGC -> ACCCCGGTGCG
TACCTTGGCGT -> ACCTTGGCGTA
CTACCTTGGCG -> TACCTTGGCGT
TACGTTGCTAC -> ACGTTGCTACA
TACTCCGATAT -> ACTCCGATATT
CTACTCCGATA -> TACTCCGATAT
TACTTTCGAAG -> ACTTTCGAAGT
TAGACAGTTCC -> AGACAGTTCCC
TAGAGTACTTA -> AGAGTACTTAC
TAGCAACAAAA -> AGCAACAAAAT
TAGCCCGGACC -> AGCCCGGACCT
CTAGCCCGGAC -> TAGCCCGGACC
TAGCCTCAAGG -> AGCCTCAAGGT
CTAGCCTCAAG -> TAGCCTCAAGG
TAGCTTAACTG -> AGCTTAACTGC
TAGCTTGCATT -> AGCTTGCATTA
TAGGATAGCCA -> AGGATAGCCAT
TAGGGCTCTCA -> AGGGCTCTCAA
CTAGGGCTCTC -> TAGGGCTCTCA
TAGGTGGAGCC -> AGGTGGAGCCA
TAGTAAACGCG -> AGTAAACGCGT
TAGTCCAGGAT -> AGTCCAGGATG
CTAGTCCAGGA -> TAGTCCAGGAT
TATCTGCTTGA -> ATCTGCTTGAT
CTATCTGCTTG -> TATCTGCTTGA
TATGCGATGCA -> ATGCGATGCAC
TATGGGAGGGC -> ATGGGAGGGCT
TCAACTTGATG -> CAACTTGATGG
CTCAACTTGAT -> TCAACTTGATG
TCAAGGACCTC -> CAAGGACCTCC
TCAAGGTAGCA -> CAAGGTAGCAC
TCAATACTCCG -> CAATACTCCGA
CTCAATACTCC -> TCAATACTCCG
TCACCGCAGAG -> CACCGCAGAGA
CTCACCGCAGA -> TCACCGCAGAG
TCAGATTCGTT -> CAGATTCGTTA
TCAGCCTTGCC -> CAGCCTTGCCC
CTCAGCCTTGC -> TCAGCCTTGCC
TCATCCTTGGC -> CATCCTTGGCC
CTCATCCTTGG -> TCATCCTTGGC
TCCAACAAGCC -> CCAACAAGCCT
TCCACATAAAA -> CCACATAAAAT
CTCCACATAAA -> TCCACATAAAA
TCCAGTAATAC -> CCAGTAATACC
TCCCGCAGCTC -> CCCGCAGCTCG
CTCCCGCAGCT -> TCCCGCAGCTC
TCCGATATTGC -> CCGATATTGCG
TCCGATTCTAA -> CCGATTCTAAA
TCCGCGCTAGG -> CCGCGCTAGGG
CTCCGCGCTAG -> TCCGCGCTAGG
TCCGCTCCCGC -> CCGCTCCCGCA
CTCCGCTCCCG -> TCCGCTCCCGC
TCCGGAAAGTG -> CCGGAAAGTGC
CTCCGGAAAGT -> TCCGGAAAGTG
TCCGGACAACA -> CCGGACAACAC
TCCGGACGTGG -> CCGGACGTGGA
CTCCGGACGTG -> TCCGGACGTGG
TCCTAGGATAG -> CCTAGGATAGC
TCCTTCTCATC -> CCTTCTCATCC
CTCCTTCTCAT -> TCCTTCTCATC
TCGACCCCTAT -> CGACCCCTATG
TCGATAGGACT -> CGATAGGACTG
TCGATGCCGAC -> CGATGCCGACA
CTCGATGCCGA -> TCGATGCCGAC
TCGATGCGAGA -> CGATGCGAGAG
CTCGATGCGAG -> TCGATGCGAGA
TCGCCTAATCT -> CGCCTAATCTC
CTCGCCTAATC -> TCGCCTAATCT
TCGCTACCTTG -> CGCTACCTTGG
CTCGCTACCTT -> TCGCTACCTTG
TCGCTGAGTCC -> CGCTGAGTCCG
CTCGCTGAGTC -> TCGCTGAGTCC
TCGGAGACCGG -> CGGAGACCGGA
CTCGGAGACCG -> TCGGAGACCGG
TCGGCGTTTTA -> CGGCGTTTTAA
TCGTCAAGCTT -> CGTCAAGCTTT
TCGTCCGTATA -> CGTCCGTATAC
CTCGTCCGTAT -> TCGTCCGTATA
TCGTCTTTTTT -> CGTCTTTTTTA
CTCGTCTTTTT -> TCGTCTTTTTT
TCGTTCGTGCT -> CGTTCGTGCTG
CTCGTTCGTGC -> TCGTTCGTGCT
TCTACAGAGGT -> CTACAGAGGTA
TCTCAACTTGA -> CTCAACTTGAT
CTCTCAACTTG -> TCTCAACTTGA
TCTCAATACTC -> CTCAATACTCC
TCTCCGCGCTA -> CTCCGCGCTAG
TCTCGATGCGA -> CTCGATGCGAG
CTCTCGATGCG -> TCTCGATGCGA
TCTCGCTACCT -> CTCGCTACCTT
TCTCGGAGACC -> CTCGGAGACCG
TCTCGTCCGTA -> CTCGTCCGTAT
TCTTCGAACCA -> CTTCGAACCAC
CTCTTCGAACC -> TCTTCGAACCA
TCTTGCAACTA -> CTTGCAACTAT
TGAACCAGAAC -> GAACCAGAACT
CTGAACCAGAA -> TGAACCAGAAC
TGAACTCTCGC -> GAACTCTCGCT
TGACGGTCTCG -> GACGGTCTCGC
TGAGGACAGCT -> GAGGACAGCTT
TGAGTCCGATT -> GAGTCCGATTA
CTGAGTCCGAT -> TGAGTCCGATT
TGATTCCTACC -> GATTCCTACCC
TGATTTTGGGT -> GATTTTGGGTA
TGCAGTATCGC -> GCAGTATCGCA
CTGCAGTATCG -> TGCAGTATCGC
TGCATTAGAAG -> GCATTAGAAGA
TGCATTGGTAC -> GCATTGGTACA
TGCCCGACCTA -> GCCCGACCTAA
CTGCCCGACCT -> TGCCCGACCTA
TGCCCTCTCAA -> GCCCTCTCAAT
TGCGTCTAGCC -> GCGTCTAGCCT
TGCTATCTGCT -> GCTATCTGCTT
TGCTTGATTAA -> GCTTGATTAAA
CTGCTTGATTA -> TGCTTGATTAA
TGGAGGACGAG -> GGAGGACGAGA
CTGGAGGACGA -> TGGAGGACGAG
TGGCGATACGA -> GGCGATACGAT
CTGGCGATACG -> TGGCGATACGA
TGGGGTGTTTA -> GGGGTGTTTAT
CTGGGGTGTTT -> TGGGGTGTTTA
TGGGTATCATA -> GGGTATCATAT
TGGTGGATGAT -> GGTGGATGATT
TGTCACAGTCT -> GTCACAGTCTG
CTGTCACAGTC -> TGTCACAGTCT
TGTCACTGAAC -> GTCACTGAACT
CTGTCACTGAA -> TGTCACTGAAC
TGTCCCCGGTA -> GTCCCCGGTAA
TGTCTTGGGAC -> GTCTTGGGACG
TGTGCGTAAGG -> GTGCGTAAGGC
TGTGTAGATAG -> GTGTAGATAGA
CTGTGTAGATA -> TGTGTAGATAG
TGTGTGAGAAT -> GTGTGAGAATA
TGTTAGTACTC -> GTTAGTACTCC
CTGTTAGTACT -> TGTTAGTACTC
TGTTCGTATAA -> GTTCGTATAAT
CTGTTCGTATA -> TGTTCGTATAA
TGTTGAGTTTA -> GTTGAGTTTAC
CTGTTGAGTTT -> TGTTGAGTTTA
TGTTGCCCGTG -> GTTGCCCGTGC
CTGTTGCCCGT -> TGTTGCCCGTG
TGTTGTGAGCA -> GTTGTGAGCAC
TGTTGTGTAGG -> GTTGTGTAGGC
TTAAACTGCAT -> TAAACTGCATT
CTTAAACTGCA -> TTAAACTGCAT
TTAACCAAAAC -> TAACCAAAACG
CTTAACCAAAA -> TTAACCAAAAC
TTAACTGCGTC -> TAACTGCGTCT
CTTAACTGCGT -> TTAACTGCGTC
TTAACTTTGTC -> TAACTTTGTCT
TTACATGGTCC -> TACATGGTCCG
TTACTTAACTT -> TACTTAACTTT
TTCCGGAATTC -> TCCGGAATTCT
CTTCCGGAATT -> TTCCGGAATTC
TTCGAACCACG -> TCGAACCACGT
CTTCGAACCAC -> TTCGAACCACG
TTCTCATCCTT -> TCTCATCCTTG
TTGACAGTAAT -> TGACAGTAATT
CTTGACAGTAA -> TTGACAGTAAT
TTGAGTAGTCT -> TGAGTAGTCTC
TTGATGGTGAA -> TGATGGTGAAG
TTGATTAAAAG -> TGATTAAAAGA
CTTGATTAAAA -> TTGATTAAAAG
TTGATTCAAGC -> TGATTCAAGCC
TTGCAACTATG -> TGCAACTATGC
CTTGCAACTAT -> TTGCAACTATG
TTGCATTACAA -> TGCATTACAAC
CTTGCATTACA -> TTGCATTACAA
TTGCCCTTTAG -> TGCCCTTTAGA
TTGCGTGGAAG -> TGCGTGGAAGA
TTGGCCCTCGG -> TGGCCCTCGGC
TTGGCGTAGCC -> TGGCGTAGCCT
TTGGGACGATC -> TGGGACGATCA
CTTGGGACGAT -> TTGGGACGATC
TTGTTAAAACC -> TGTTAAAACCA
TTTAAGCTTAA -> TTAAGCTTAAC
TTTACTGATTC -> TTACTGATTCC
TTTAGAACTCA -> TTAGAACTCAG
TTTAGGAATGC -> TTAGGAATGCG
CTTTAGGAATG -> TTTAGGAATGC
TTTCAATAGTC -> TTCAATAGTCG
CTTTCAATAGT -> TTTCAATAGTC
TTTCCACCATA -> TTCCACCATAT
TTTCGAAGTTG -> TTCGAAGTTGT
TTTCGGGAAAC -> TTCGGGAAACC
TTTGAAGCCAT -> TTGAAGCCATA
CTTTGAAGCCA -> TTTGAAGCCAT
TTTGATTTGAG -> TTGATTTGAGA
TTTGTCGATTA -> TTGTCGATTAC
TTTGTCGCCAA -> TTGTCGCCAAC
CTTTGTCGCCA -> TTTGTCGCCAA
TTTGTCTAGTC -> TTGTCTAGTCC
TTTTTTAACCC -> TTTTTAACCCC
CTTTTTTAACC -> TTTTTTAACCC
GAAACCTCCAG -> AAACCTCCAGT
GAAAGTGCGGT -> AAAGTGCGGTG
GAAATGTTCGG -> AAATGTTCGGG
GAACCAGAACT -> AACCAGAACTT
GAACTCTCGCT -> AACTCTCGCTA
GAACTGACGGT -> AACTGACGGTC
GAAGACCCTGT -> AAGACCCTGTC
GAAGATACGCC -> AAGATACGCCG
GAAGATGTCGT -> AAGATGTCGTC
GAAGCCATAGA -> AAGCCATAGAC
GAATAGCTTTC -> AATAGCTTTCA
GAATCGGATAC -> AATCGGATACA
GAATCTGAACC -> AATCTGAACCA
GAATGCGGGGA -> AATGCGGGGAT
GAATTCTGGCG -> AATTCTGGCGA
GACAACACCGC -> ACAACACCGCT
GACACCCGCTT -> ACACCCGCTTG
GACACCGCGGT -> ACACCGCGGTC
GACAGCTTTGT -> ACAGCTTTGTC
GACAGTAATTC -> ACAGTAATTCA
GACCGCGTCAC -> ACCGCGTCACT
GACCTCCTAGG -> ACCTCCTAGGA
GACCTCGATAG -> ACCTCGATAGG
GACGACTTTAC -> ACGACTTTACT
GACGAGACCAG -> ACGAGACCAGC
GACGATCATAC -> ACGATCATACT
GACGGAGCCAA -> ACGGAGCCAAC
GACGGCCTCTA -> ACGGCCTCTAC
GACGGTCTCGC -> ACGGTCTCGCC
GACGTGGATCG -> ACGTGGATCGC
GACTGCATTAG -> ACTGCATTAGA
GACTTGATTCA -> ACTTGATTCAA
GACTTGCGTGG -> ACTTGCGTGGA
GAGAAAGAATG -> AGAAAGAATGC
GAGAATACCTC -> AGAATACCTCA
GAGACCGGACA -> AGACCGGACAC
GAGATGACCGC -> AGATGACCGCG
GAGCACGTATT -> AGCACGTATTT
GAGCCAACACA -> AGCCAACACAA
GAGCCAACATC -> AGCCAACATCT
GAGCCCCCCTC -> AGCCCCCCTCT
GAGGACAGCTT -> AGGACAGCTTT
GAGGACGAGAC -> AGGACGAGACC
GAGGGCTCGAT -> AGGGCTCGATG
GAGGTAAGTCG -> AGGTAAGTCGA
GAGTAGTCTCT -> AGTAGTCTCTT
GAGTCCGATTA -> AGTCCGATTAG
GAGTTGGGCAA -> AGTTGGGCAAC
GAGTTTACCTT -> AGTTTACCTTT
GATAAGTGCGG -> ATAAGTGCGGT
GATACATAGGT -> ATACATAGGTA
GATACTTTGAT -> ATACTTTGATT
GATAGCCATCT -> ATAGCCATCTG
GATATAACCCT -> ATATAACCCTT
GATCGCATCCG -> ATCGCATCCGC
GATGATTTCCT -> ATGATTTCCTA
GATGCAACTAC -> ATGCAACTACG
GATGGGAAGAT -> ATGGGAAGATG
GATGGTGAAGA -> ATGGTGAAGAC
GATTAAAAGAA -> ATTAAAAGAAT
GATTCAAGCCC -> ATTCAAGCCCC
GATTCCTACCC -> ATTCCTACCCC
GATTCTCGTTC -> ATTCTCGTTCG
GATTTCCTAGC -> ATTTCCTAGCT
GATTTGAGAAA -> ATTTGAGAAAG
GATTTTGGGTA -> ATTTTGGGTAG
GATTTTGTGAT -> ATTTTGTGATA
GCAACGTAACC -> CAACGTAACCA
GCAACTACGTT -> CAACTACGTTG
GCAACTATGCG -> CAACTATGCGA
GCACATGAATA -> CACATGAATAG
GCACGCTCTCG -> CACGCTCTCGA
GCAGTATCGCA -> CAGTATCGCAT
GCATCAAACAC -> CATCAAACACT
GCATCCTCTCG -> CATCCTCTCGG
GCATGGACACC -> CATGGACACCG
GCATTAATGTG -> CATTAATGTGC
GCATTACAACC -> CATTACAACCT
GCATTAGAAGA -> CATTAGAAGAA
GCATTGGTACA -> CATTGGTACAT
GCATTTAAGCG -> CATTTAAGCGC
GCCCCACAATT -> CCCCACAATTT
GCCCGACCTAA -> CCCGACCTAAG
GCCCGTGCTCC -> CCCGTGCTCCG
GCCCTCGGCGT -> CCCTCGGCGTT
GCCCTCTCAAT -> CCCTCTCAATA
GCCCTTTAGAA -> CCCTTTAGAAC
GCCGACACTTT -> CCGACACTTTC
GCCGATGTACT -> CCGATGTACTG
GCCGGATGCAA -> CCGGATGCAAC
GCCGTATTTCC -> CCGTATTTCCC
GCCTAGACAGT -> CCTAGACAGTT
GCCTCTACAGA -> CCTCTACAGAG
GCCTGCCCTCT -> CCTGCCCTCTC
GCGACAGCAGG -> CGACAGCAGGC
GCGAGAGGCAT -> CGAGAGGCATC
GCGATACGATG -> CGATACGATGA
GCGATGCACGC -> CGATGCACGCT
GCGCACGACCG -> CGCACGACCGT
GCGCTTCCGGA -> CGCTTCCGGAA
GCGGGGATTCT -> CGGGGATTCTC
GCGGTATCAGA -> CGGTATCAGAA
GCGGTGACTTG -> CGGTGACTTGC
GCGTAAGGCTG -> CGTAAGGCTGT
GCGTAGATTGC -> CGTAGATTGCA
GCGTAGCCTGT -> CGTAGCCTGTT
GCGTCTAGCCT -> CGTCTAGCCTC
GCGTGGAAGAT -> CGTGGAAGATA
GCGTTTTAAGC -> CGTTTTAAGCT
GCTACAGAGGC -> CTACAGAGGCG
GCTACCAACAC -> CTACCAACACC
GCTATCTGCTT -> CTATCTGCTTG
GCTCAGCCTTG -> CTCAGCCTTGC
GCTCCGGAAAG -> CTCCGGAAAGT
GCTCGATGCCG -> CTCGATGCCGA
GCTCTCAACTT -> CTCTCAACTTG
GCTGTCACAGT -> CTGTCACAGTC
GCTGTGTAGAT -> CTGTGTAGATA
GCTGTTAGTAC -> CTGTTAGTACT
GCTGTTCGTAT -> CTGTTCGTATA
GCTTAAACTGC -> CTTAAACTGCA
GCTTGATTAAA -> CTTGATTAAAA
GGAAACCTCCA -> GAAACCTCCAG
GGAAATGTTCG -> GAAATGTTCGG
GGAAGATACGC -> GAAGATACGCC
GGAAGATGTCG -> GAAGATGTCGT
GGACACCGCGG -> GACACCGCGGT
GGACGATCATA -> GACGATCATAC
GGACTTGATTC -> GACTTGATTCA
GGAGCCAACAT -> GAGCCAACATC
GGAGCCCCCCT -> GAGCCCCCCTC
GGAGGACGAGA -> GAGGACGAGAC
GGAGGGCTCGA -> GAGGGCTCGAT
GGAGGTAAGTC -> GAGGTAAGTCG
GGATAAGTGCG -> GATAAGTGCGG
GGATACTTTGA -> GATACTTTGAT
GGATCGCATCC -> GATCGCATCCG
GGATGATTTCC -> GATGATTTCCT
GGATTCTCGTT -> GATTCTCGTTC
GGCAACGTAAC -> GCAACGTAACC
GGCATCCTCTC -> GCATCCTCTCG
GGCCCTCGGCG -> GCCCTCGGCGT
GGCCGATGTAC -> GCCGATGTACT
GGCCTAGACAG -> GCCTAGACAGT
GGCGATACGAT -> GCGATACGATG
GGCGTAGCCTG -> GCGTAGCCTGT
GGCTCAGCCTT -> GCTCAGCCTTG
GGCTCGATGCC -> GCTCGATGCCG
GGCTCTCAACT -> GCTCTCAACTT
GGGAAGATGTC -> GGAAGATGTCG
GGGACGATCAT -> GGACGATCATA
GGGAGGGCTCG -> GGAGGGCTCGA
GGGATAAGTGC -> GGATAAGTGCG
GGGATTCTCGT -> GGATTCTCGTT
GGGCAACGTAA -> GGCAACGTAAC
GGGTGTTTATT -> GGTGTTTATTG
GGGGTGTTTAT -> GGGTGTTTATT
GGTAAACCCCA -> GTAAACCCCAG
GGTAATCAATT -> GTAATCAATTC
GGTAGACTCTT -> GTAGACTCTTG
GGGTAGACTCT -> GGTAGACTCTT
GGTATCATATA -> GTATCATATAT
GGGTATCATAT -> GGTATCATATA
GGTGTTTATTG -> GTGTTTATTGG
GTAAGTCGAAC -> TAAGTCGAACC
GTAATCAATTC -> TAATCAATTCT
GTAATGCTACC -> TAATGCTACCA
GTACAAGGGCA -> TACAAGGGCAT
GTACATGTTAT -> TACATGTTATG
GGTACATGTTA -> GTACATGTTAT
GTAGACTCTTG -> TAGACTCTTGC
GTAGATATCGG -> TAGATATCGGC
GTAGCACTGTG -> TAGCACTGTGC
GTAGTCTCCAC -> TAGTCTCCACA
GGTAGTCTCCA -> GTAGTCTCCAC
GTATCAGAACG -> TATCAGAACGA
GTATCATATAT -> TATCATATATC
GTCACCACTAA -> TCACCACTAAT
GTCCGAAGCCA -> TCCGAAGCCAA
GGTCCGAAGCC -> GTCCGAAGCCA
GTCCTAGTAAA -> TCCTAGTAAAC
GTCCTGTGTGA -> TCCTGTGTGAG
GTCTCGCCTAA -> TCTCGCCTAAT
GTCTGGAGGAC -> TCTGGAGGACG
GGTCTGGAGGA -> GTCTGGAGGAC
GTGAAGACCCT -> TGAAGACCCTG
GGTGAAGACCC -> GTGAAGACCCT
GTGAATCGGAT -> TGAATCGGATA
GGTGAATCGGA -> GTGAATCGGAT
GTGACTTGCGT -> TGACTTGCGTG
GTGCACATGAA -> TGCACATGAAT
GTGCGACAGCA -> TGCGACAGCAG
GTGGAGCCAAC -> TGGAGCCAACA
GTGGATGATTT -> TGGATGATTTC
GGTGGATGATT -> GTGGATGATTT
GTGTTTATTGG -> TGTTTATTGGC
GTTAGGGAGGT -> TTAGGGAGGTA
GTTCTCACCGC -> TTCTCACCGCA
TAAACGCGTGT -> AAACGCGTGTG
TAACCATTCAA -> AACCATTCAAT
TAAGCCACGGG -> AAGCCACGGGT
GTAAGCCACGG -> TAAGCCACGGG
TAAGGCTGTCA -> AAGGCTGTCAC
TAAGTCGAACC -> AAGTCGAACCA
TAATACCCGGC -> AATACCCGGCA
TAATCAATTCT -> AATCAATTCTG
TAATGCTACCA -> AATGCTACCAA
TAATTCACTAG -> AATTCACTAGC
TACAAGGGCAT -> ACAAGGGCATC
TACATGTTATG -> ACATGTTATGG
TACTCCAACAA -> ACTCCAACAAG
TACTGAGGACA -> ACTGAGGACAG
TACTGTCTTGG -> ACTGTCTTGGG
GTACTGTCTTG -> TACTGTCTTGG
TACTTACTTAA -> ACTTACTTAAC
TAGACTCTTGC -> AGACTCTTGCA
TAGATAGAGTG -> AGATAGAGTGA
GTAGATAGAGT -> TAGATAGAGTG
TAGATATCGGC -> AGATATCGGCT
TAGATTGCATT -> AGATTGCATTA
TAGCACTGTGC -> AGCACTGTGCG
TAGCCTGTTGT -> AGCCTGTTGTG
TAGGCATGGAC -> AGGCATGGACA
GTAGGCATGGA -> TAGGCATGGAC
TAGGCCCCACA -> AGGCCCCACAA
GTAGGCCCCAC -> TAGGCCCCACA
TAGTCTCCACA -> AGTCTCCACAT
TAGTCTCTTCG -> AGTCTCTTCGA
TATAATGGTGA -> ATAATGGTGAA
TATACCTAGGT -> ATACCTAGGTG
TATAGTACTGA -> ATAGTACTGAG
GTATAGTACTG -> TATAGTACTGA
TATCAGAACGA -> ATCAGAACGAA
TATCATATATC -> ATCATATATCG
TATCGCATGAA -> ATCGCATGAAC
TATGGAGCCCC -> ATGGAGCCCCC
TATTTAAGGTG -> ATTTAAGGTGC
TATTTCCCGGG -> ATTTCCCGGGA
TCAAGCTTTGA -> CAAGCTTTGAA
TCACAGTCTGT -> CACAGTCTGTC
GTCACAGTCTG -> TCACAGTCTGT
TCACCACTAAT -> CACCACTAATC
TCACTGAACTC -> CACTGAACTCT
GTCACTGAACT -> TCACTGAACTC
TCACTGCTATC -> CACTGCTATCT
TCAGATCGTTA -> CAGATCGTTAC
TCCAGGATGGG -> CCAGGATGGGA
TCCCCGGTAAT -> CCCCGGTAATG
GTCCCCGGTAA -> TCCCCGGTAAT
TCCGAAGCCAA -> CCGAAGCCAAT
TCCGATTAGTG -> CCGATTAGTGG
TCCGTATACCT -> CCGTATACCTA
TCCTAGTAAAC -> CCTAGTAAACG
TCCTGTGTGAG -> CCTGTGTGAGA
TCGAACCATGT -> CGAACCATGTC
TCGACCGAAGC -> CGACCGAAGCA
TCGATTACCAG -> CGATTACCAGC
GTCGATTACCA -> TCGATTACCAG
TCGCCAACTTG -> CGCCAACTTGT
GTCGCCAACTT -> TCGCCAACTTG
TCGCGGTTCTC -> CGCGGTTCTCA
GTCGCGGTTCT -> TCGCGGTTCTC
TCGGTCCTGTG -> CGGTCCTGTGT
TCGTCAGATCG -> CGTCAGATCGT
GTCGTCAGATC -> TCGTCAGATCG
TCTAGCCTCAA -> CTAGCCTCAAG
TCTAGTCCAGG -> CTAGTCCAGGA
GTCTAGTCCAG -> TCTAGTCCAGG
TCTCCACATAA -> CTCCACATAAA
TCTCCGCTCCC -> CTCCGCTCCCG
GTCTCCGCTCC -> TCTCCGCTCCC
TCTCGCCTAAT -> CTCGCCTAATC
TCTCTTCGAAC -> CTCTTCGAACC
TCTGCCCGACC -> CTGCCCGACCT
GTCTGCCCGAC -> TCTGCCCGACC
TCTGGAGGACG -> CTGGAGGACGA
TCTGTCACTGA -> CTGTCACTGAA
TCTTGGGACGA -> CTTGGGACGAT
GTCTTGGGACG -> TCTTGGGACGA
TCTTTTTTAAC -> CTTTTTTAACC
TGAAGACCCTG -> GAAGACCCTGT
TGAATCGGATA -> GAATCGGATAC
TGACTTGCGTG -> GACTTGCGTGG
TGAGAATACCT -> GAGAATACCTC
GTGAGAATACC -> TGAGAATACCT
TGAGCACGTAT -> GAGCACGTATT
GTGAGCACGTA -> TGAGCACGTAT
TGAGTTGGGCA -> GAGTTGGGCAA
TGATATAACCC -> GATATAACCCT
GTGATATAACC -> TGATATAACCC
TGCACATGAAT -> GCACATGAATA
TGCGACAGCAG -> GCGACAGCAGG
TGCGGTATCAG -> GCGGTATCAGA
TGCGGTGACTT -> GCGGTGACTTG
TGCGTAAGGCT -> GCGTAAGGCTG
GTGCGTAAGGC -> TGCGTAAGGCT
TGCTCCGGAAA -> GCTCCGGAAAG
TGCTGTTAGTA -> GCTGTTAGTAC
GTGCTGTTAGT -> TGCTGTTAGTA
TGCTGTTCGTA -> GCTGTTCGTAT
TGGAAATGTTC -> GGAAATGTTCG
TGGAAGATACG -> GGAAGATACGC
TGGAGCCAACA -> GGAGCCAACAT
TGGATACTTTG -> GGATACTTTGA
TGGATCGCATC -> GGATCGCATCC
TGGATGATTTC -> GGATGATTTCC
TGTAGATAGAG -> GTAGATAGAGT
GTGTAGATAGA -> TGTAGATAGAG
TGTAGGCATGG -> GTAGGCATGGA
GTGTAGGCATG -> TGTAGGCATGG
TGTAGGCCCCA -> GTAGGCCCCAC
GTGTAGGCCCC -> TGTAGGCCCCA
TGTCGCGGTTC -> GTCGCGGTTCT
GTGTCGCGGTT -> TGTCGCGGTTC
TGTGAGAATAC -> GTGAGAATACC
GTGTGAGAATA -> TGTGAGAATAC
TGTGTCGCGGT -> GTGTCGCGGTT
TGTTTATTGGC -> GTTTATTGGCC
TTAAAACCACG -> TAAAACCACGG
GTTAAAACCAC -> TTAAAACCACG
TTAAATTTCCA -> TAAATTTCCAA
TTACCCTCGAC -> TACCCTCGACC
TTACGTTAAAT -> TACGTTAAATT
TTAGGGAGGTA -> TAGGGAGGTAA
TTAGTACTCCA -> TAGTACTCCAA
GTTAGTACTCC -> TTAGTACTCCA
TTATGGTAGTC -> TATGGTAGTCT
GTTATGGTAGT -> TTATGGTAGTC
TTCCCCCCGAC -> TCCCCCCGACT
TTCGGGCCGAT -> TCGGGCCGATG
GTTCGGGCCGA -> TTCGGGCCGAT
TTCGTATAATG -> TCGTATAATGG
GTTCGTATAAT -> TTCGTATAATG
TTCGTGCTGTT -> TCGTGCTGTTC
TTCTCACCGCA -> TCTCACCGCAG
TTCTTTAGGAA -> TCTTTAGGAAT
TTGAGTTTACC -> TGAGTTTACCT
GTTGAGTTTAC -> TTGAGTTTACC
TTGCCCGTGCT -> TGCCCGTGCTC
GTTGCCCGTGC -> TTGCCCGTGCT
TTGCTACAGAG -> TGCTACAGAGG
TTGGGCAACGT -> TGGGCAACGTA
TTGTATAGTAC -> TGTATAGTACT
TTGTGAGCACG -> TGTGAGCACGT
GTTGTGAGCAC -> TTGTGAGCACG
TTGTGTAGGCA -> TGTGTAGGCAT
TTGTGTAGGCC -> TGTGTAGGCCC
TTTACCTTTGT -> TTACCTTTGTC
TTTATTGGCCT -> TTATTGGCCTA
GTTTATTGGCC -> TTTATTGGCCT
TTTCTCCGGAC -> TTCTCCGGACG
TTTTAACATCG -> TTTAACATCGG
GTTTTAACATC -> TTTTAACATCG
TTTTAAGCTGT -> TTTAAGCTGTT
TAAAACCACGG -> AAAACCACGGG
TAAAAGAATGT -> AAAAGAATGTC
TAAACTGCATT -> AAACTGCATTG
TAAATTTCCAA -> AAATTTCCAAG
TAACATCGGTT -> AACATCGGTTA
TAACCAAAACG -> AACCAAAACGC
TAACCCCTTTA -> AACCCCTTTAA
TAACTGCGTCT -> AACTGCGTCTA
TAACTTTGTCT -> AACTTTGTCTA
TAAGCGCGAAC -> AAGCGCGAACA
TAAGCTGTTGC -> AAGCTGTTGCC
TAAGCTTAACC -> AAGCTTAACCA
TAAGGTGCACA -> AAGGTGCACAT
TAATGTGCTGT -> AATGTGCTGTT
TACAACCTCCG -> ACAACCTCCGG
TACATGGTCCG -> ACATGGTCCGA
TACCAGCAAAG -> ACCAGCAAAGA
TACCCTCGACC -> ACCCTCGACCC
TACCTTTGTCG -> ACCTTTGTCGA
TACGTTAAATT -> ACGTTAAATTT
TACTGATTCCT -> ACTGATTCCTA
TACTTAACTTT -> ACTTAACTTTG
TAGAACTCAGA -> AGAACTCAGAT
TAGAAGAACGA -> AGAAGAACGAA
TAGGAATGCGG -> AGGAATGCGGG
TAGGGAGGTAA -> AGGGAGGTAAG
TAGTACTCCAA -> AGTACTCCAAC
TAGTGGAAATG -> AGTGGAAATGT
TATGGTAGTCT -> ATGGTAGTCTC
TATTGGCCTAG -> ATTGGCCTAGA
TCAAGCCCCCC -> CAAGCCCCCCT
TCAATAGAGAA -> CAATAGAGAAA
TCAATAGTCGG -> CAATAGTCGGT
TCAATGACGGC -> CAATGACGGCC
TCACTAGCAAC -> CACTAGCAACA
TCCAAGGGGAT -> CCAAGGGGATA
TCCACCATATG -> CCACCATATGA
TCCCCCCGACT -> CCCCCCGACTA
TCCCGATATGG -> CCCGATATGGT
TCCCGGGACTT -> CCCGGGACTTG
TCCGGAATTCT -> CCGGAATTCTG
TCCTACCCCGG -> CCTACCCCGGT
TCCTAGCTTGC -> CCTAGCTTGCA
TCCTGGTGGAT -> CCTGGTGGATG
TCGAACCACGT -> CGAACCACGTT
TCGAAGTTGTG -> CGAAGTTGTGT
TCGGGAAACCT -> CGGGAAACCTC
TCGGGCCGATG -> CGGGCCGATGT
TCGTATAATGG -> CGTATAATGGT
TCGTGCTGTTC -> CGTGCTGTTCG
TCGTTACCCTC -> CGTTACCCTCG
TCTAAAAGGAG -> CTAAAAGGAGA
TCTCACCGCAG -> CTCACCGCAGA
TCTCATCCTTG -> CTCATCCTTGG
TCTCCGGACGT -> CTCCGGACGTG
TCTCGTTCGTG -> CTCGTTCGTGC
TCTGGCGATAC -> CTGGCGATACG
TCTGGGGTGTT -> CTGGGGTGTTT
TCTTTAGGAAT -> CTTTAGGAATG
TGAAGCCATAG -> GAAGCCATAGA
TGACAGTAATT -> GACAGTAATTC
TGAGAAAGAAT -> GAGAAAGAATG
TGAGTAGTCTC -> GAGTAGTCTCT
TGAGTTTACCT -> GAGTTTACCTT
TGATGGTGAAG -> GATGGTGAAGA
TGATTAAAAGA -> GATTAAAAGAA
TGATTCAAGCC -> GATTCAAGCCC
TGATTTGAGAA -> GATTTGAGAAA
TGCAACTATGC -> GCAACTATGCG
TGCATTAATGT -> GCATTAATGTG
TGCATTACAAC -> GCATTACAACC
TGCCCGTGCTC -> GCCCGTGCTCC
TGCCCTTTAGA -> GCCCTTTAGAA
TGCGTAGATTG -> GCGTAGATTGC
TGCGTGGAAGA -> GCGTGGAAGAT
TGCTACAGAGG -> GCTACAGAGGC
TGGCCCTCGGC -> GGCCCTCGGCG
TGGCCTAGACA -> GGCCTAGACAG
TGGCGTAGCCT -> GGCGTAGCCTG
TGGGACGATCA -> GGGACGATCAT
TGGGCAACGTA -> GGGCAACGTAA
TGGGTAGACTC -> GGGTAGACTCT
TGGTACATGTT -> GGTACATGTTA
TGTATAGTACT -> GTATAGTACTG
TGTCGATTACC -> GTCGATTACCA
TGTCGCCAACT -> GTCGCCAACTT
TGTCTAGTCCA -> GTCTAGTCCAG
TGTGAGCACGT -> GTGAGCACGTA
TGTGATATAAC -> GTGATATAACC
TGTGTAGGCAT -> GTGTAGGCATG
TGTGTAGGCCC -> GTGTAGGCCCC
TGTTAAAACCA -> GTTAAAACCAC
TTAACATCGGT -> TAACATCGGTT
TTAACCCCTTT -> TAACCCCTTTA
TTAAGCGCGAA -> TAAGCGCGAAC
TTAAGCTGTTG -> TAAGCTGTTGC
TTAAGCTTAAC -> TAAGCTTAACC
TTAAGGTGCAC -> TAAGGTGCACA
TTACCTTTGTC -> TACCTTTGTCG
TTACTGATTCC -> TACTGATTCCT
TTAGAACTCAG -> TAGAACTCAGA
TTAGGAATGCG -> TAGGAATGCGG
TTATTGGCCTA -> TATTGGCCTAG
TTCAATAGTCG -> TCAATAGTCGG
TTCCAAGGGGA -> TCCAAGGGGAT
TTCCACCATAT -> TCCACCATATG
TTCCCGGGACT -> TCCCGGGACTT
TTCCTAGCTTG -> TCCTAGCTTGC
TTCCTGGTGGA -> TCCTGGTGGAT
TTCGAAGTTGT -> TCGAAGTTGTG
TTCGGGAAACC -> TCGGGAAACCT
TTCTCCGGACG -> TCTCCGGACGT
TTGAAGCCATA -> TGAAGCCATAG
TTGAGAAAGAA -> TGAGAAAGAAT
TTGATTTGAGA -> TGATTTGAGAA
TTGGGTAGACT -> TGGGTAGACTC
TTGTCGATTAC -> TGTCGATTACC
TTGTCGCCAAC -> TGTCGCCAACT
TTGTCTAGTCC -> TGTCTAGTCCA
TTGTGATATAA -> TGTGATATAAC
TTTAACATCGG -> TTAACATCGGT
TTTAACCCCTT -> TTAACCCCTTT
TTTAAGCTGTT -> TTAAGCTGTTG
TTTGGGTAGAC -> TTGGGTAGACT
TTTGTGATATA -> TTGTGATATAA
TTTTAACCCCT -> TTTAACCCCTT
TTTTTAACCCC -> TTTTAACCCCT
