AAAAACCTCGTTCAATCAT -> AAAACCTCGTTCAATCATT
AAAAAGCAGTTTGGGGTGG -> AAAAGCAGTTTGGGGTGGG
AAAACCTCGTTCAATCATT -> AAACCTCGTTCAATCATTA
AAAACGGTGTGTGAAAAGT -> AAACGGTGTGTGAAAAGTC
AAAACGTGGGGTCGCCGCC -> AAACGTGGGGTCGCCGCCC
AAAACTTCAGCCAGAGCTG -> AAACTTCAGCCAGAGCTGG
AAAAGCAGTTTGGGGTGGG -> AAAGCAGTTTGGGGTGGGC
AAAAGTCCCATACTGGTGG -> AAAGTCCCATACTGGTGGA
AAAATAATGGTTCTCTCTG -> AAATAATGGTTCTCTCTGA
AAAATGCCAAGGAGAATAC -> AAATGCCAAGGAGAATACA
AAACACCAATGTTCTCGAG -> AACACCAATGTTCTCGAGG
AAACCCCACGGAAGGGGTG -> AACCCCACGGAAGGGGTGG
AAACCCGCAATTATAGCGG -> AACCCGCAATTATAGCGGG
AAACCGTCGGGAAATCACC -> AACCGTCGGGAAATCACCA
AAACCTCGTTCAATCATTA -> AACCTCGTTCAATCATTAC
AAACGAGGGAATGCTGCTC -> AACGAGGGAATGCTGCTCC
AAACGGTGTGTGAAAAGTC -> AACGGTGTGTGAAAAGTCC
AAACGTGGGGTCGCCGCCC -> AACGTGGGGTCGCCGCCCT
AAACGTTATCGTGAAACCC -> AACGTTATCGTGAAACCCC
AAACTTCAGCCAGAGCTGG -> AACTTCAGCCAGAGCTGGG
AAACTTTCCACCTAGGGTA -> AACTTTCCACCTAGGGTAC
AAAGACCAAAGCCTCACCA -> AAGACCAAAGCCTCACCAC
AAAGCAGTTTGGGGTGGGC -> AAGCAGTTTGGGGTGGGCA
AAAGCCACAACTTTGGGGA -> AAGCCACAACTTTGGGGAT
AAAGCCGGGCTCAGCATCC -> AAGCCGGGCTCAGCATCCC
AAAGCCTCACCACATTCTT -> AAGCCTCACCACATTCTTA
AAAGGCGGCTAGTGGCGGA -> AAGGCGGCTAGTGGCGGAC
AAAGGGCACACCTAACCTT -> AAGGGCACACCTAACCTTT
AAAGTCCCATACTGGTGGA -> AAGTCCCATACTGGTGGAA
AAAGTGCCTGTTCCACGAG -> AAGTGCCTGTTCCACGAGA
AAAGTTATTAGCCTAGCCA -> AAGTTATTAGCCTAGCCAT
AAATAATGGTTCTCTCTGA -> AATAATGGTTCTCTCTGAA
AAATACCGGCCGAGGTAAT -> AATACCGGCCGAGGTAATG
AAATCACCAAAGCCGGGCT -> AATCACCAAAGCCGGGCTC
AAATCGATAAGAGATAGCC -> AATCGATAAGAGATAGCCG
AAATGCCAAGGAGAATACA -> AATGCCAAGGAGAATACAT
AAATTCCCGGAGCACCCAT -> AATTCCCGGAGCACCCATG
AAATTTTGCCTCGCGTATA -> AATTTTGCCTCGCGTATAG
AACAATGCATTGTCTTCTC -> ACAATGCATTGTCTTCTCG
AACACAGAAGGCAGACTGT -> ACACAGAAGGCAGACTGTC
AACACCAATGTTCTCGAGG -> ACACCAATGTTCTCGAGGA
AACAGGTTCGCGATAGACC -> ACAGGTTCGCGATAGACCA
AACATGTCTGGATAAGACA -> ACATGTCTGGATAAGACAC
AACCAGCCTACTCCAAGGA -> ACCAGCCTACTCCAAGGAC
AACCCCACGGAAGGGGTGG -> ACCCCACGGAAGGGGTGGG
AACCCGCAATTATAGCGGG -> ACCCGCAATTATAGCGGGC
AACCGTAGCGCATGCAAAT -> ACCGTAGCGCATGCAAATT
AACCGTCGGGAAATCACCA -> ACCGTCGGGAAATCACCAA
AACCGTGCACTACTTTCGA -> ACCGTGCACTACTTTCGAT
AACCTCGTTCAATCATTAC -> ACCTCGTTCAATCATTACT
AACCTTTCGATGGGCTGCT -> ACCTTTCGATGGGCTGCTA
AACGAGGGAATGCTGCTCC -> ACGAGGGAATGCTGCTCCC
AACGCGCCCATTTCTTAGG -> ACGCGCCCATTTCTTAGGA
AACGGTGTGTGAAAAGTCC -> ACGGTGTGTGAAAAGTCCC
AACGTGGGGTCGCCGCCCT -> ACGTGGGGTCGCCGCCCTG
AACGTTATCGTGAAACCCC -> ACGTTATCGTGAAACCCCA
AACTTCAGCCAGAGCTGGG -> ACTTCAGCCAGAGCTGGGC
AACTTGAAGCGATTTCATG -> ACTTGAAGCGATTTCATGC
AACTTTACTGCTAAAAAGC -> ACTTTACTGCTAAAAAGCA
AACTTTCCACCTAGGGTAC -> ACTTTCCACCTAGGGTACG
AACTTTGGGGATTTGCAAA -> ACTTTGGGGATTTGCAAAC
AACTTTTGTGTTAGCGAGT -> ACTTTTGTGTTAGCGAGTA
AAGACACAAAATAATGGTT -> AGACACAAAATAATGGTTC
AAGACAGCCGGAATAACTT -> AGACAGCCGGAATAACTTT
AAGACCAAAGCCTCACCAC -> AGACCAAAGCCTCACCACA
AAGAGAGCGTCCACCCCTA -> AGAGAGCGTCCACCCCTAG
AAGAGATAGCCGGTGGTTG -> AGAGATAGCCGGTGGTTGC
AAGATCGAATAGAAACGTT -> AGATCGAATAGAAACGTTA
AAGCAGGTCTTCTTCGACA -> AGCAGGTCTTCTTCGACAA
AAGCAGTTTGGGGTGGGCA -> AGCAGTTTGGGGTGGGCAT
AAGCCACAACTTTGGGGAT -> AGCCACAACTTTGGGGATT
AAGCCGGGCTCAGCATCCC -> AGCCGGGCTCAGCATCCCA
AAGCCTCACCACATTCTTA -> AGCCTCACCACATTCTTAA
AAGCGATTTCATGCTCGGA -> AGCGATTTCATGCTCGGAC
AAGCTACCTTATGATCTCC -> AGCTACCTTATGATCTCCA
AAGCTGGCTCGTGTTTTAA -> AGCTGGCTCGTGTTTTAAA
AAGGACCATGCCACGGGAC -> AGGACCATGCCACGGGACA
AAGGACTTCCCGCGGAGTG -> AGGACTTCCCGCGGAGTGG
AAGGAGAATACATAGTTCC -> AGGAGAATACATAGTTCCG
AAGGAGCCTGTCTCGTAAG -> AGGAGCCTGTCTCGTAAGT
AAGGCAGACTGTCTTGTAC -> AGGCAGACTGTCTTGTACG
AAGGCGGCTAGTGGCGGAC -> AGGCGGCTAGTGGCGGACA
AAGGGCACACCTAACCTTT -> AGGGCACACCTAACCTTTC
AAGGGGTGGGCTGTACTCC -> AGGGGTGGGCTGTACTCCA
AAGGGTTATGGAGAAAGTG -> AGGGTTATGGAGAAAGTGC
AAGTACAGTTGATTCAATC -> AGTACAGTTGATTCAATCT
AAGTACGTAGTGTACTAGT -> AGTACGTAGTGTACTAGTT
AAGTATGTGTGCCTCGGCA -> AGTATGTGTGCCTCGGCAC
AAGTCCCATACTGGTGGAA -> AGTCCCATACTGGTGGAAC
AAGTCGATCGAGTGCGAGC -> AGTCGATCGAGTGCGAGCT
AAGTGCCTGTTCCACGAGA -> AGTGCCTGTTCCACGAGAG
AAGTGCGAGAGGTCACAGT -> AGTGCGAGAGGTCACAGTG
AAGTGGCACCATGCACCGA -> AGTGGCACCATGCACCGAC
AAGTTATTAGCCTAGCCAT -> AGTTATTAGCCTAGCCATA
AATAAAGACCAAAGCCTCA -> ATAAAGACCAAAGCCTCAC
AATAACTTTACTGCTAAAA -> ATAACTTTACTGCTAAAAA
AATAATGGTTCTCTCTGAA -> ATAATGGTTCTCTCTGAAT
AATACATAGTTCCGTCCGG -> ATACATAGTTCCGTCCGGA
AATACCGGAATTACTTCAA -> ATACCGGAATTACTTCAAC
AATACCGGCCGAGGTAATG -> ATACCGGCCGAGGTAATGT
AATACGAGATATTACTCCC -> ATACGAGATATTACTCCCT
AATACGTGGACGATCGATC -> ATACGTGGACGATCGATCT
AATAGAAACGTTATCGTGA -> ATAGAAACGTTATCGTGAA
AATAGTGACGAATATCAAC -> ATAGTGACGAATATCAACA
AATATCAACACAGAAGGCA -> ATATCAACACAGAAGGCAG
AATATCTCAGAGAGGTGGT -> ATATCTCAGAGAGGTGGTG
AATATGAAGATCGAATAGA -> ATATGAAGATCGAATAGAA
AATCACCAAAGCCGGGCTC -> ATCACCAAAGCCGGGCTCA
AATCAGATATACTTGCACG -> ATCAGATATACTTGCACGG
AATCATTACTGTAGAGGAT -> ATCATTACTGTAGAGGATG
AATCCCCTAGGCAGTAGTT -> ATCCCCTAGGCAGTAGTTT
AATCGATAAGAGATAGCCG -> ATCGATAAGAGATAGCCGG
AATCGATGTGAGTTCTTAC -> ATCGATGTGAGTTCTTACA
AATCTTAGGTGCAGCGACT -> ATCTTAGGTGCAGCGACTC
AATGAGGTCCGTCATATTA -> ATGAGGTCCGTCATATTAA
AATGCATTGTCTTCTCGAA -> ATGCATTGTCTTCTCGAAG
AATGCCAAGGAGAATACAT -> ATGCCAAGGAGAATACATA
AATGCTGCTCCCAGCAGCA -> ATGCTGCTCCCAGCAGCAA
AATGGCTCAAATCGATAAG -> ATGGCTCAAATCGATAAGA
AATGGTTCTCTCTGAATAC -> ATGGTTCTCTCTGAATACG
AATGTCTGTCCATCTAGCA -> ATGTCTGTCCATCTAGCAT
AATGTTCTCGAGGATGCCC -> ATGTTCTCGAGGATGCCCT
AATTAATGAGGTCCGTCAT -> ATTAATGAGGTCCGTCATA
AATTACTTCAACCGTAGCG -> ATTACTTCAACCGTAGCGC
AATTATAGCGGGCGTCCGG -> ATTATAGCGGGCGTCCGGG
AATTCCCGGAGCACCCATG -> ATTCCCGGAGCACCCATGT
AATTCGCGAGCTTTCTACG -> ATTCGCGAGCTTTCTACGC
AATTGATCTTGGCTGAATA -> ATTGATCTTGGCTGAATAC
AATTTTCTCGGTTGTGTGC -> ATTTTCTCGGTTGTGTGCC
AATTTTGCCTCGCGTATAG -> ATTTTGCCTCGCGTATAGG
ACAAAATAATGGTTCTCTC -> CAAAATAATGGTTCTCTCT
ACAAACACCAATGTTCTCG -> CAAACACCAATGTTCTCGA
ACAACAATGCATTGTCTTC -> CAACAATGCATTGTCTTCT
ACAACCAGCCTACTCCAAG -> CAACCAGCCTACTCCAAGG
ACAACTTTGGGGATTTGCA -> CAACTTTGGGGATTTGCAA
ACAATGCATTGTCTTCTCG -> CAATGCATTGTCTTCTCGA
ACACAAAATAATGGTTCTC -> CACAAAATAATGGTTCTCT
ACACAACCAGCCTACTCCA -> CACAACCAGCCTACTCCAA
ACACAGAAGGCAGACTGTC -> CACAGAAGGCAGACTGTCT
ACACCAATGTTCTCGAGGA -> CACCAATGTTCTCGAGGAT
ACACCTAACCTTTCGATGG -> CACCTAACCTTTCGATGGG
ACACTGGTTACATATCACC -> CACTGGTTACATATCACCC
ACAGAAGGCAGACTGTCTT -> CAGAAGGCAGACTGTCTTG
ACAGACCGATACCCAAGCT -> CAGACCGATACCCAAGCTG
ACAGACCGGATCCACCTCC -> CAGACCGGATCCACCTCCG
ACAGACGCAGGTCTTAAAA -> CAGACGCAGGTCTTAAAAC
ACAGACTCTCATTCTCATT -> CAGACTCTCATTCTCATTT
ACAGCCATAGCGTCGATCT -> CAGCCATAGCGTCGATCTC
ACAGCCGGAATAACTTTAC -> CAGCCGGAATAACTTTACT
ACAGGGCCCGCTAAAATGC -> CAGGGCCCGCTAAAATGCC
ACAGGTTCGCGATAGACCA -> CAGGTTCGCGATAGACCAT
ACAGGTTGGCTTGACCGAG -> CAGGTTGGCTTGACCGAGA
ACAGTCGCAGCATTACTAG -> CAGTCGCAGCATTACTAGA
ACAGTGATTAGTTACACAA -> CAGTGATTAGTTACACAAC
ACAGTTGATTCAATCTTAG -> CAGTTGATTCAATCTTAGG
ACATAATATGAAGATCGAA -> CATAATATGAAGATCGAAT
ACATAGCCACCCAAAACGT -> CATAGCCACCCAAAACGTG
ACATAGTTCCGTCCGGATC -> CATAGTTCCGTCCGGATCC
ACATATCACCCATCAATTA -> CATATCACCCATCAATTAA
ACATCTTGAATTCGCGAGC -> CATCTTGAATTCGCGAGCT
ACATGTCTGGATAAGACAC -> CATGTCTGGATAAGACACA
ACATTCTTAACTTGAAGCG -> CATTCTTAACTTGAAGCGA
ACATTGACCCCACGCGATC -> CATTGACCCCACGCGATCG
ACCAAAGCCGGGCTCAGCA -> CCAAAGCCGGGCTCAGCAT
ACCAAAGCCTCACCACATT -> CCAAAGCCTCACCACATTC
ACCAATGTTCTCGAGGATG -> CCAATGTTCTCGAGGATGC
ACCACATTCTTAACTTGAA -> CCACATTCTTAACTTGAAG
ACCAGCCTACTCCAAGGAC -> CCAGCCTACTCCAAGGACC
ACCAGTAGCATATTCCGCC -> CCAGTAGCATATTCCGCCT
ACCATGCACCGACGTGTGA -> CCATGCACCGACGTGTGAA
ACCATGCCACGGGACAAAC -> CCATGCCACGGGACAAACA
ACCATGGCCAGACTGCTTC -> CCATGGCCAGACTGCTTCT
ACCCAAAACGTGGGGTCGC -> CCCAAAACGTGGGGTCGCC
ACCCAAGCTGGCTCGTGTT -> CCCAAGCTGGCTCGTGTTT
ACCCATCAATTAATGAGGT -> CCCATCAATTAATGAGGTC
ACCCATGTATTCATTCGCG -> CCCATGTATTCATTCGCGC
ACCCCACGCGATCGTCTTA -> CCCCACGCGATCGTCTTAG
ACCCCACGGAAGGGGTGGG -> CCCCACGGAAGGGGTGGGC
ACCCCGACGGGATAGTTCT -> CCCCGACGGGATAGTTCTA
ACCCCTAGAAAGTTATTAG -> CCCCTAGAAAGTTATTAGC
ACCCGCAATTATAGCGGGC -> CCCGCAATTATAGCGGGCG
ACCGACGTGTGAATACCGG -> CCGACGTGTGAATACCGGA
ACCGAGATGAGTACCAGTA -> CCGAGATGAGTACCAGTAG
ACCGATACCCAAGCTGGCT -> CCGATACCCAAGCTGGCTC
ACCGGAATTACTTCAACCG -> CCGGAATTACTTCAACCGT
ACCGGATCCACCTCCGTGT -> CCGGATCCACCTCCGTGTT
ACCGGCCGAGGTAATGTCT -> CCGGCCGAGGTAATGTCTG
ACCGTAGCGCATGCAAATT -> CCGTAGCGCATGCAAATTT
ACCGTATAAGTATGTGTGC -> CCGTATAAGTATGTGTGCC
ACCGTCGGGAAATCACCAA -> CCGTCGGGAAATCACCAAA
ACCGTGCACTACTTTCGAT -> CCGTGCACTACTTTCGATC
ACCTAACCTTTCGATGGGC -> CCTAACCTTTCGATGGGCT
ACCTAGGGTACGTCCCCAC -> CCTAGGGTACGTCCCCACG
ACCTCATGTGGACGATTGA -> CCTCATGTGGACGATTGAT
ACCTCCGTGTTTGTAAATT -> CCTCCGTGTTTGTAAATTC
ACCTCGTTCAATCATTACT -> CCTCGTTCAATCATTACTG
ACCTCTACGAAGTGGCACC -> CCTCTACGAAGTGGCACCA
ACCTGTGTAACCGTGCACT -> CCTGTGTAACCGTGCACTA
ACCTTATGATCTCCAAACC -> CCTTATGATCTCCAAACCC
ACCTTTCGATGGGCTGCTA -> CCTTTCGATGGGCTGCTAA
ACGAAGTGGCACCATGCAC -> CGAAGTGGCACCATGCACC
ACGAATATCAACACAGAAG -> CGAATATCAACACAGAAGG
ACGAGAGAAATACCGGCCG -> CGAGAGAAATACCGGCCGA
ACGAGATATTACTCCCTAC -> CGAGATATTACTCCCTACA
ACGAGCCCAAGGAGCCTGT -> CGAGCCCAAGGAGCCTGTC
ACGAGGGAATGCTGCTCCC -> CGAGGGAATGCTGCTCCCA
ACGAGGGTCCTGTGTAGTG -> CGAGGGTCCTGTGTAGTGC
ACGATAGCAGGTCGATGAG -> CGATAGCAGGTCGATGAGT
ACGATCGATCTCCTCGGGT -> CGATCGATCTCCTCGGGTA
ACGATTGATTTTGCGGTGA -> CGATTGATTTTGCGGTGAA
ACGCAGGTCTTAAAACGGT -> CGCAGGTCTTAAAACGGTG
ACGCGATCGTCTTAGTTCC -> CGCGATCGTCTTAGTTCCG
ACGCGCCCATTTCTTAGGA -> CGCGCCCATTTCTTAGGAG
ACGCTGATGAATGGCTCAA -> CGCTGATGAATGGCTCAAA
ACGGAAGGGGTGGGCTGTA -> CGGAAGGGGTGGGCTGTAC
ACGGCCGCGTGAGAGCAGC -> CGGCCGCGTGAGAGCAGCG
ACGGCCTGACCTCTACGAA -> CGGCCTGACCTCTACGAAG
ACGGCGAGTGTACTACGGG -> CGGCGAGTGTACTACGGGA
ACGGCGTTGAACTTCCGCA -> CGGCGTTGAACTTCCGCAA
ACGGGAAGTACGTAGTGTA -> CGGGAAGTACGTAGTGTAC
ACGGGACAAACACCAATGT -> CGGGACAAACACCAATGTT
ACGGGATAGTTCTAAACTT -> CGGGATAGTTCTAAACTTT
ACGGTGTGTGAAAAGTCCC -> CGGTGTGTGAAAAGTCCCA
ACGTAGTGTACTAGTTCCG -> CGTAGTGTACTAGTTCCGT
ACGTAGTTCCGTCCGGATC -> CGTAGTTCCGTCCGGATCC
ACGTCCCCACGTGACATTG -> CGTCCCCACGTGACATTGA
ACGTGACATTGACCCCACG -> CGTGACATTGACCCCACGC
ACGTGGACGATCGATCTCC -> CGTGGACGATCGATCTCCT
ACGTGGGGTCGCCGCCCTG -> CGTGGGGTCGCCGCCCTGT
ACGTGTGAATACCGGAATT -> CGTGTGAATACCGGAATTA
ACGTTATCGTGAAACCCCA -> CGTTATCGTGAAACCCCAC
ACTACGGGAAGTACGTAGT -> CTACGGGAAGTACGTAGTG
ACTACTTTCGATCCATCAT -> CTACTTTCGATCCATCATA
ACTAGAAGCTACCTTATGA -> CTAGAAGCTACCTTATGAT
ACTAGTTCCGTCCGGATCC -> CTAGTTCCGTCCGGATCCA
ACTATATTATTATTGGCAC -> CTATATTATTATTGGCACG
ACTATGGTGTTGTGTGCCT -> CTATGGTGTTGTGTGCCTC
ACTCACAGCCATAGCGTCG -> CTCACAGCCATAGCGTCGA
ACTCCAAGGACCATGCCAC -> CTCCAAGGACCATGCCACG
ACTCCATTGAGCAAAAACC -> CTCCATTGAGCAAAAACCT
ACTCCCTACATCTTGAATT -> CTCCCTACATCTTGAATTC
ACTCCGCATACCTCATGTG -> CTCCGCATACCTCATGTGG
ACTCGCAGTACTCCGCATA -> CTCGCAGTACTCCGCATAC
ACTCTCATTCTCATTTGCT -> CTCTCATTCTCATTTGCTT
ACTGCTAAAAAGCAGTTTG -> CTGCTAAAAAGCAGTTTGG
ACTGCTTCTAGCCTCGGTC -> CTGCTTCTAGCCTCGGTCT
ACTGGTGGAACAGGTTCGC -> CTGGTGGAACAGGTTCGCG
ACTGGTTACATATCACCCA -> CTGGTTACATATCACCCAT
ACTGTAGAGGATGATATTG -> CTGTAGAGGATGATATTGT
ACTGTAGTAAGTGCGAGAG -> CTGTAGTAAGTGCGAGAGG
ACTGTCTTGTACGATAGCA -> CTGTCTTGTACGATAGCAG
ACTTCAACCGTAGCGCATG -> CTTCAACCGTAGCGCATGC
ACTTCAGCCAGAGCTGGGC -> CTTCAGCCAGAGCTGGGCG
ACTTCCCGCGGAGTGGGCG -> CTTCCCGCGGAGTGGGCGT
ACTTGAAGCGATTTCATGC -> CTTGAAGCGATTTCATGCT
ACTTGCACGGCGTTGAACT -> CTTGCACGGCGTTGAACTT
ACTTTACTGCTAAAAAGCA -> CTTTACTGCTAAAAAGCAG
ACTTTCCACCTAGGGTACG -> CTTTCCACCTAGGGTACGT
ACTTTCGATCCATCATATA -> CTTTCGATCCATCATATAA
ACTTTGGGGATTTGCAAAC -> CTTTGGGGATTTGCAAACG
ACTTTTGTGTTAGCGAGTA -> CTTTTGTGTTAGCGAGTAA
AGAAACGTTATCGTGAAAC -> GAAACGTTATCGTGAAACC
AGAAAGTGCCTGTTCCACG -> GAAAGTGCCTGTTCCACGA
AGAAAGTTATTAGCCTAGC -> GAAAGTTATTAGCCTAGCC
AGAAATACCGGCCGAGGTA -> GAAATACCGGCCGAGGTAA
AGAAGCTACCTTATGATCT -> GAAGCTACCTTATGATCTC
AGAAGGCAGACTGTCTTGT -> GAAGGCAGACTGTCTTGTA
AGAATACATAGTTCCGTCC -> GAATACATAGTTCCGTCCG
AGACACAAAATAATGGTTC -> GACACAAAATAATGGTTCT
AGACAGCCGGAATAACTTT -> GACAGCCGGAATAACTTTA
AGACAGTCGCAGCATTACT -> GACAGTCGCAGCATTACTA
AGACCAAAGCCTCACCACA -> GACCAAAGCCTCACCACAT
AGACCATGGCCAGACTGCT -> GACCATGGCCAGACTGCTT
AGACCGATACCCAAGCTGG -> GACCGATACCCAAGCTGGC
AGACCGGATCCACCTCCGT -> GACCGGATCCACCTCCGTG
AGACGCAGGTCTTAAAACG -> GACGCAGGTCTTAAAACGG
AGACTATGGTGTTGTGTGC -> GACTATGGTGTTGTGTGCC
AGACTCTCATTCTCATTTG -> GACTCTCATTCTCATTTGC
AGACTGCTTCTAGCCTCGG -> GACTGCTTCTAGCCTCGGT
AGACTGTCTTGTACGATAG -> GACTGTCTTGTACGATAGC
AGAGAAATACCGGCCGAGG -> GAGAAATACCGGCCGAGGT
AGAGAGCGTCCACCCCTAG -> GAGAGCGTCCACCCCTAGA
AGAGAGGGTTTTGAGTACA -> GAGAGGGTTTTGAGTACAC
AGAGAGGTGGTGGGGCCCC -> GAGAGGTGGTGGGGCCCCG
AGAGATAGCCGGTGGTTGC -> GAGATAGCCGGTGGTTGCA
AGAGCAGCGGTGGAACATG -> GAGCAGCGGTGGAACATGT
AGAGCGTCCACCCCTAGAA -> GAGCGTCCACCCCTAGAAA
AGAGCTGGGCGGGAGCTTA -> GAGCTGGGCGGGAGCTTAT
AGAGGATGATATTGTTCCT -> GAGGATGATATTGTTCCTC
AGAGGGTTTTGAGTACACT -> GAGGGTTTTGAGTACACTG
AGAGGTCACAGTGATTAGT -> GAGGTCACAGTGATTAGTT
AGAGGTGGTGGGGCCCCGA -> GAGGTGGTGGGGCCCCGAA
AGATAGCCGGTGGTTGCAC -> GATAGCCGGTGGTTGCACA
AGATATACTTGCACGGCGT -> GATATACTTGCACGGCGTT
AGATATTACTCCCTACATC -> GATATTACTCCCTACATCT
AGATCGAATAGAAACGTTA -> GATCGAATAGAAACGTTAT
AGATGAGTACCAGTAGCAT -> GATGAGTACCAGTAGCATA
AGCAAAAACCTCGTTCAAT -> GCAAAAACCTCGTTCAATC
AGCAAGGACTTCCCGCGGA -> GCAAGGACTTCCCGCGGAG
AGCACCCATGTATTCATTC -> GCACCCATGTATTCATTCG
AGCAGCAAGGACTTCCCGC -> GCAGCAAGGACTTCCCGCG
AGCAGCGGTGGAACATGTC -> GCAGCGGTGGAACATGTCT
AGCAGGTCGATGAGTGGCA -> GCAGGTCGATGAGTGGCAT
AGCAGGTCTTCTTCGACAA -> GCAGGTCTTCTTCGACAAC
AGCAGTTTGGGGTGGGCAT -> GCAGTTTGGGGTGGGCATT
AGCATATTCCGCCTTCTGC -> GCATATTCCGCCTTCTGCG
AGCATCCCAATAAAGACCA -> GCATCCCAATAAAGACCAA
AGCATTACTAGAAGCTACC -> GCATTACTAGAAGCTACCT
AGCATTGTGGACGGCGAGT -> GCATTGTGGACGGCGAGTG
AGCCACAACTTTGGGGATT -> GCCACAACTTTGGGGATTT
AGCCACCCAAAACGTGGGG -> GCCACCCAAAACGTGGGGT
AGCCAGAGCTGGGCGGGAG -> GCCAGAGCTGGGCGGGAGC
AGCCATAATCGATGTGAGT -> GCCATAATCGATGTGAGTT
AGCCATAGCGTCGATCTCC -> GCCATAGCGTCGATCTCCG
AGCCCAAGGAGCCTGTCTC -> GCCCAAGGAGCCTGTCTCG
AGCCGGAATAACTTTACTG -> GCCGGAATAACTTTACTGC
AGCCGGGCTCAGCATCCCA -> GCCGGGCTCAGCATCCCAA
AGCCGGTGGTTGCACAGGG -> GCCGGTGGTTGCACAGGGC
AGCCTACTCCAAGGACCAT -> GCCTACTCCAAGGACCATG
AGCCTAGCCATAATCGATG -> GCCTAGCCATAATCGATGT
AGCCTCACCACATTCTTAA -> GCCTCACCACATTCTTAAC
AGCCTCGGTCTGCGTTTTG -> GCCTCGGTCTGCGTTTTGC
AGCCTGTCTCGTAAGTACA -> GCCTGTCTCGTAAGTACAG
AGCGACTCGCAGTACTCCG -> GCGACTCGCAGTACTCCGC
AGCGAGTAATCCCCTAGGC -> GCGAGTAATCCCCTAGGCA
AGCGATTTCATGCTCGGAC -> GCGATTTCATGCTCGGACT
AGCGCATGCAAATTTTGCC -> GCGCATGCAAATTTTGCCT
AGCGGCGGTACGAGGGTCC -> GCGGCGGTACGAGGGTCCT
AGCGGGCGTCCGGGAAGAC -> GCGGGCGTCCGGGAAGACA
AGCGGTGGAACATGTCTGG -> GCGGTGGAACATGTCTGGA
AGCGTCCACCCCTAGAAAG -> GCGTCCACCCCTAGAAAGT
AGCGTCGATCTCCGCAAAA -> GCGTCGATCTCCGCAAAAC
AGCTACCTTATGATCTCCA -> GCTACCTTATGATCTCCAA
AGCTCAGACAGTCGCAGCA -> GCTCAGACAGTCGCAGCAT
AGCTGGCTCGTGTTTTAAA -> GCTGGCTCGTGTTTTAAAG
AGCTGGGCGGGAGCTTATC -> GCTGGGCGGGAGCTTATCA
AGCTGGTATAATTGATCTT -> GCTGGTATAATTGATCTTG
AGCTTATCATGAGCGGCGG -> GCTTATCATGAGCGGCGGT
AGCTTTCTACGCTGATGAA -> GCTTTCTACGCTGATGAAT
AGGACCATGCCACGGGACA -> GGACCATGCCACGGGACAA
AGGACTTCCCGCGGAGTGG -> GGACTTCCCGCGGAGTGGG
AGGAGAATACATAGTTCCG -> GGAGAATACATAGTTCCGT
AGGAGAGAGGGTTTTGAGT -> GGAGAGAGGGTTTTGAGTA
AGGAGCCTGTCTCGTAAGT -> GGAGCCTGTCTCGTAAGTA
AGGATGATATTGTTCCTCG -> GGATGATATTGTTCCTCGT
AGGATGCCCTTCAGCTCAG -> GGATGCCCTTCAGCTCAGA
AGGCAGACTGTCTTGTACG -> GGCAGACTGTCTTGTACGA
AGGCAGTAGTTTGTTGCAG -> GGCAGTAGTTTGTTGCAGT
AGGCGGCTAGTGGCGGACA -> GGCGGCTAGTGGCGGACAT
AGGGAATGCTGCTCCCAGC -> GGGAATGCTGCTCCCAGCA
AGGGCACACCTAACCTTTC -> GGGCACACCTAACCTTTCG
AGGGCCCGCTAAAATGCCA -> GGGCCCGCTAAAATGCCAA
AGGGGTGGGCTGTACTCCA -> GGGGTGGGCTGTACTCCAT
AGGGTACGTCCCCACGTGA -> GGGTACGTCCCCACGTGAC
AGGGTCCTGTGTAGTGCGA -> GGGTCCTGTGTAGTGCGAC
AGGGTTATGGAGAAAGTGC -> GGGTTATGGAGAAAGTGCC
AGGGTTTTGAGTACACTGG -> GGGTTTTGAGTACACTGGT
AGGTAATGTCTGTCCATCT -> GGTAATGTCTGTCCATCTA
AGGTCACAGTGATTAGTTA -> GGTCACAGTGATTAGTTAC
AGGTCCGTCATATTAAGAG -> GGTCCGTCATATTAAGAGA
AGGTCGATGAGTGGCATCA -> GGTCGATGAGTGGCATCAC
AGGTCTTAAAACGGTGTGT -> GGTCTTAAAACGGTGTGTG
AGGTCTTCTTCGACAACAA -> GGTCTTCTTCGACAACAAT
AGGTGCAGCGACTCGCAGT -> GGTGCAGCGACTCGCAGTA
AGGTGGGTAAGCAGGTCTT -> GGTGGGTAAGCAGGTCTTC
AGGTGGTGGGGCCCCGAAC -> GGTGGTGGGGCCCCGAACT
AGGTTCGCGATAGACCATG -> GGTTCGCGATAGACCATGG
AGGTTGGCTTGACCGAGAT -> GGTTGGCTTGACCGAGATG
AGTAAGTGCGAGAGGTCAC -> GTAAGTGCGAGAGGTCACA
AGTAATCCCCTAGGCAGTA -> GTAATCCCCTAGGCAGTAG
AGTACACTGGTTACATATC -> GTACACTGGTTACATATCA
AGTACAGTTGATTCAATCT -> GTACAGTTGATTCAATCTT
AGTACCAGTAGCATATTCC -> GTACCAGTAGCATATTCCG
AGTACGTAGTGTACTAGTT -> GTACGTAGTGTACTAGTTC
AGTACTCCGCATACCTCAT -> GTACTCCGCATACCTCATG
AGTAGCATATTCCGCCTTC -> GTAGCATATTCCGCCTTCT
AGTAGTTTGTTGCAGTGTA -> GTAGTTTGTTGCAGTGTAA
AGTATGTGTGCCTCGGCAC -> GTATGTGTGCCTCGGCACA
AGTCCCATACTGGTGGAAC -> GTCCCATACTGGTGGAACA
AGTCGATCGAGTGCGAGCT -> GTCGATCGAGTGCGAGCTG
AGTCGCAGCATTACTAGAA -> GTCGCAGCATTACTAGAAG
AGTGACGAATATCAACACA -> GTGACGAATATCAACACAG
AGTGATTAGTTACACAACC -> GTGATTAGTTACACAACCA
AGTGCCTGTTCCACGAGAG -> GTGCCTGTTCCACGAGAGA
AGTGCGACCTGTGTAACCG -> GTGCGACCTGTGTAACCGT
AGTGCGAGAGGTCACAGTG -> GTGCGAGAGGTCACAGTGA
AGTGCGAGCTGGTATAATT -> GTGCGAGCTGGTATAATTG
AGTGGCACCATGCACCGAC -> GTGGCACCATGCACCGACG
AGTGGCATCACGTAGTTCC -> GTGGCATCACGTAGTTCCG
AGTGGCGGACATAGCCACC -> GTGGCGGACATAGCCACCC
AGTGGGCGTCTTGACGGCC -> GTGGGCGTCTTGACGGCCG
AGTGTAATCAGATATACTT -> GTGTAATCAGATATACTTG
AGTGTACTACGGGAAGTAC -> GTGTACTACGGGAAGTACG
AGTGTACTAGTTCCGTCCG -> GTGTACTAGTTCCGTCCGG
AGTTACACAACCAGCCTAC -> GTTACACAACCAGCCTACT
AGTTATTAGCCTAGCCATA -> GTTATTAGCCTAGCCATAA
AGTTCCGTCCGGATCCAAT -> GTTCCGTCCGGATCCAATT
AGTTCCGTCCGGATCCACC -> GTTCCGTCCGGATCCACCG
AGTTCCGTCCGGATCCAGA -> GTTCCGTCCGGATCCAGAC
AGTTCCGTCCGGATCCATT -> GTTCCGTCCGGATCCATTG
AGTTCTAAACTTTCCACCT -> GTTCTAAACTTTCCACCTA
AGTTCTTACATAATATGAA -> GTTCTTACATAATATGAAG
AGTTGATTCAATCTTAGGT -> GTTGATTCAATCTTAGGTG
AGTTTGGGGTGGGCATTAC -> GTTTGGGGTGGGCATTACA
AGTTTGTTGCAGTGTAATC -> GTTTGTTGCAGTGTAATCA
ATAAAGACCAAAGCCTCAC -> TAAAGACCAAAGCCTCACC
ATAAAGGCGGCTAGTGGCG -> TAAAGGCGGCTAGTGGCGG
ATAACTTTACTGCTAAAAA -> TAACTTTACTGCTAAAAAG
ATAAGACACAAAATAATGG -> TAAGACACAAAATAATGGT
ATAAGAGATAGCCGGTGGT -> TAAGAGATAGCCGGTGGTT
ATAAGTATGTGTGCCTCGG -> TAAGTATGTGTGCCTCGGC
ATAATATGAAGATCGAATA -> TAATATGAAGATCGAATAG
ATAATCGATGTGAGTTCTT -> TAATCGATGTGAGTTCTTA
ATAATGGTTCTCTCTGAAT -> TAATGGTTCTCTCTGAATA
ATAATTGATCTTGGCTGAA -> TAATTGATCTTGGCTGAAT
ATACATAGTTCCGTCCGGA -> TACATAGTTCCGTCCGGAT
ATACCCAAGCTGGCTCGTG -> TACCCAAGCTGGCTCGTGT
ATACCGGAATTACTTCAAC -> TACCGGAATTACTTCAACC
ATACCGGCCGAGGTAATGT -> TACCGGCCGAGGTAATGTC
ATACCTCATGTGGACGATT -> TACCTCATGTGGACGATTG
ATACGAGATATTACTCCCT -> TACGAGATATTACTCCCTA
ATACGTGGACGATCGATCT -> TACGTGGACGATCGATCTC
ATACTGGTGGAACAGGTTC -> TACTGGTGGAACAGGTTCG
ATACTTGCACGGCGTTGAA -> TACTTGCACGGCGTTGAAC
ATAGAAACGTTATCGTGAA -> TAGAAACGTTATCGTGAAA
ATAGACCATGGCCAGACTG -> TAGACCATGGCCAGACTGC
ATAGCAGGTCGATGAGTGG -> TAGCAGGTCGATGAGTGGC
ATAGCCACCCAAAACGTGG -> TAGCCACCCAAAACGTGGG
ATAGCCGGTGGTTGCACAG -> TAGCCGGTGGTTGCACAGG
ATAGCGGGCGTCCGGGAAG -> TAGCGGGCGTCCGGGAAGA
ATAGCGTCGATCTCCGCAA -> TAGCGTCGATCTCCGCAAA
ATAGGTGGGTAAGCAGGTC -> TAGGTGGGTAAGCAGGTCT
ATAGTGACGAATATCAACA -> TAGTGACGAATATCAACAC
ATAGTTCCGTCCGGATCCA -> TAGTTCCGTCCGGATCCAA
ATAGTTCTAAACTTTCCAC -> TAGTTCTAAACTTTCCACC
ATATAAAGGCGGCTAGTGG -> TATAAAGGCGGCTAGTGGC
ATATACTTGCACGGCGTTG -> TATACTTGCACGGCGTTGA
ATATCAACACAGAAGGCAG -> TATCAACACAGAAGGCAGA
ATATCACCCATCAATTAAT -> TATCACCCATCAATTAATG
ATATCTCAGAGAGGTGGTG -> TATCTCAGAGAGGTGGTGG
ATATGAAGATCGAATAGAA -> TATGAAGATCGAATAGAAA
ATATTAAGAGAGCGTCCAC -> TATTAAGAGAGCGTCCACC
ATATTACTCCCTACATCTT -> TATTACTCCCTACATCTTG
ATATTATTATTGGCACGAG -> TATTATTATTGGCACGAGC
ATATTCCGCCTTCTGCGTG -> TATTCCGCCTTCTGCGTGA
ATATTGTTCCTCGTCGGAC -> TATTGTTCCTCGTCGGACC
ATCAACACAGAAGGCAGAC -> TCAACACAGAAGGCAGACT
ATCAATATCTCAGAGAGGT -> TCAATATCTCAGAGAGGTG
ATCAATTAATGAGGTCCGT -> TCAATTAATGAGGTCCGTC
ATCACCAAAGCCGGGCTCA -> TCACCAAAGCCGGGCTCAG
ATCACCCATCAATTAATGA -> TCACCCATCAATTAATGAG
ATCACGTAGTTCCGTCCGG -> TCACGTAGTTCCGTCCGGA
ATCACTGTAGTAAGTGCGA -> TCACTGTAGTAAGTGCGAG
ATCAGATATACTTGCACGG -> TCAGATATACTTGCACGGC
ATCATATAAAGGCGGCTAG -> TCATATAAAGGCGGCTAGT
ATCATGAGCGGCGGTACGA -> TCATGAGCGGCGGTACGAG
ATCATTACTGTAGAGGATG -> TCATTACTGTAGAGGATGA
ATCCAATTTTCTCGGTTGT -> TCCAATTTTCTCGGTTGTG
ATCCACCGTATAAGTATGT -> TCCACCGTATAAGTATGTG
ATCCACCTCCGTGTTTGTA -> TCCACCTCCGTGTTTGTAA
ATCCAGACTATGGTGTTGT -> TCCAGACTATGGTGTTGTG
ATCCATCATATAAAGGCGG -> TCCATCATATAAAGGCGGC
ATCCATTGATGGTCCCTGT -> TCCATTGATGGTCCCTGTG
ATCCCAATAAAGACCAAAG -> TCCCAATAAAGACCAAAGC
ATCCCCTAGGCAGTAGTTT -> TCCCCTAGGCAGTAGTTTG
ATCGAATAGAAACGTTATC -> TCGAATAGAAACGTTATCG
ATCGAGTGCGAGCTGGTAT -> TCGAGTGCGAGCTGGTATA
ATCGATAAGAGATAGCCGG -> TCGATAAGAGATAGCCGGT
ATCGATCTCCTCGGGTATT -> TCGATCTCCTCGGGTATTA
ATCGATGTGAGTTCTTACA -> TCGATGTGAGTTCTTACAT
ATCGTCTTAGTTCCGTCCG -> TCGTCTTAGTTCCGTCCGG
ATCGTGAAACCCCACGGAA -> TCGTGAAACCCCACGGAAG
ATCTAGCATTGTGGACGGC -> TCTAGCATTGTGGACGGCG
ATCTCAGAGAGGTGGTGGG -> TCTCAGAGAGGTGGTGGGG
ATCTCCAAACCCGCAATTA -> TCTCCAAACCCGCAATTAT
ATCTCCGCAAAACTTCAGC -> TCTCCGCAAAACTTCAGCC
ATCTCCTCGGGTATTATCA -> TCTCCTCGGGTATTATCAC
ATCTTAGGTGCAGCGACTC -> TCTTAGGTGCAGCGACTCG
ATCTTGAATTCGCGAGCTT -> TCTTGAATTCGCGAGCTTT
ATCTTGGCTGAATACGAGA -> TCTTGGCTGAATACGAGAT
ATGAAGATCGAATAGAAAC -> TGAAGATCGAATAGAAACG
ATGAATGGCTCAAATCGAT -> TGAATGGCTCAAATCGATA
ATGAGCGGCGGTACGAGGG -> TGAGCGGCGGTACGAGGGT
ATGAGGTCCGTCATATTAA -> TGAGGTCCGTCATATTAAG
ATGAGTACCAGTAGCATAT -> TGAGTACCAGTAGCATATT
ATGAGTGGCATCACGTAGT -> TGAGTGGCATCACGTAGTT
ATGATATTGTTCCTCGTCG -> TGATATTGTTCCTCGTCGG
ATGATCTCCAAACCCGCAA -> TGATCTCCAAACCCGCAAT
ATGCAAATTTTGCCTCGCG -> TGCAAATTTTGCCTCGCGT
ATGCACCGACGTGTGAATA -> TGCACCGACGTGTGAATAC
ATGCATTGTCTTCTCGAAG -> TGCATTGTCTTCTCGAAGG
ATGCCAAGGAGAATACATA -> TGCCAAGGAGAATACATAG
ATGCCACGGGACAAACACC -> TGCCACGGGACAAACACCA
ATGCCCTTCAGCTCAGACA -> TGCCCTTCAGCTCAGACAG
ATGCTCGGACTCACAGCCA -> TGCTCGGACTCACAGCCAT
ATGCTGCTCCCAGCAGCAA -> TGCTGCTCCCAGCAGCAAG
ATGGAGAAAGTGCCTGTTC -> TGGAGAAAGTGCCTGTTCC
ATGGCCAGACTGCTTCTAG -> TGGCCAGACTGCTTCTAGC
ATGGCTCAAATCGATAAGA -> TGGCTCAAATCGATAAGAG
ATGGGCTGCTAAGTCGATC -> TGGGCTGCTAAGTCGATCG
ATGGTCCCTGTGTGCCTCG -> TGGTCCCTGTGTGCCTCGG
ATGGTGTTGTGTGCCTCGG -> TGGTGTTGTGTGCCTCGGC
ATGGTTCTCTCTGAATACG -> TGGTTCTCTCTGAATACGT
ATGTATTCATTCGCGCCTA -> TGTATTCATTCGCGCCTAA
ATGTCTGGATAAGACACAA -> TGTCTGGATAAGACACAAA
ATGTCTGTCCATCTAGCAT -> TGTCTGTCCATCTAGCATT
ATGTGAGTTCTTACATAAT -> TGTGAGTTCTTACATAATA
ATGTGGACGATTGATTTTG -> TGTGGACGATTGATTTTGC
ATGTGTGCCTCGGCACAGA -> TGTGTGCCTCGGCACAGAC
ATGTTCTCGAGGATGCCCT -> TGTTCTCGAGGATGCCCTT
ATTAAGAGAGCGTCCACCC -> TTAAGAGAGCGTCCACCCC
ATTAATGAGGTCCGTCATA -> TTAATGAGGTCCGTCATAT
ATTACAGGTTGGCTTGACC -> TTACAGGTTGGCTTGACCG
ATTACTAGAAGCTACCTTA -> TTACTAGAAGCTACCTTAT
ATTACTCCCTACATCTTGA -> TTACTCCCTACATCTTGAA
ATTACTGTAGAGGATGATA -> TTACTGTAGAGGATGATAT
ATTACTTCAACCGTAGCGC -> TTACTTCAACCGTAGCGCA
ATTAGCCTAGCCATAATCG -> TTAGCCTAGCCATAATCGA
ATTAGTTACACAACCAGCC -> TTAGTTACACAACCAGCCT
ATTATAGCGGGCGTCCGGG -> TTATAGCGGGCGTCCGGGA
ATTATCACTGTAGTAAGTG -> TTATCACTGTAGTAAGTGC
ATTATTATTGGCACGAGCC -> TTATTATTGGCACGAGCCC
ATTATTGGCACGAGCCCAA -> TTATTGGCACGAGCCCAAG
ATTCAATCTTAGGTGCAGC -> TTCAATCTTAGGTGCAGCG
ATTCATTCGCGCCTAAACC -> TTCATTCGCGCCTAAACCG
ATTCCCGGAGCACCCATGT -> TTCCCGGAGCACCCATGTA
ATTCCGCCTTCTGCGTGAT -> TTCCGCCTTCTGCGTGATC
ATTCGCGAGCTTTCTACGC -> TTCGCGAGCTTTCTACGCT
ATTCGCGCCTAAACCGTCG -> TTCGCGCCTAAACCGTCGG
ATTCTCATTTGCTTTACGG -> TTCTCATTTGCTTTACGGC
ATTCTTAACTTGAAGCGAT -> TTCTTAACTTGAAGCGATT
ATTGACCCCACGCGATCGT -> TTGACCCCACGCGATCGTC
ATTGAGCAAAAACCTCGTT -> TTGAGCAAAAACCTCGTTC
ATTGATCTTGGCTGAATAC -> TTGATCTTGGCTGAATACG
ATTGATGGTCCCTGTGTGC -> TTGATGGTCCCTGTGTGCC
ATTGATTTTGCGGTGAACG -> TTGATTTTGCGGTGAACGC
ATTGGCACGAGCCCAAGGA -> TTGGCACGAGCCCAAGGAG
ATTGTCTTCTCGAAGGGTT -> TTGTCTTCTCGAAGGGTTA
ATTGTGGACGGCGAGTGTA -> TTGTGGACGGCGAGTGTAC
ATTGTTCCTCGTCGGACCC -> TTGTTCCTCGTCGGACCCC
ATTTCATGCTCGGACTCAC -> TTTCATGCTCGGACTCACA
ATTTCTTAGGAGAGAGGGT -> TTTCTTAGGAGAGAGGGTT
ATTTGCAAACGAGGGAATG -> TTTGCAAACGAGGGAATGC
ATTTGCTTTACGGCCTGAC -> TTTGCTTTACGGCCTGACC
ATTTTCTCGGTTGTGTGCC -> TTTTCTCGGTTGTGTGCCT
ATTTTGCCTCGCGTATAGG -> TTTTGCCTCGCGTATAGGT
ATTTTGCGGTGAACGCGCC -> TTTTGCGGTGAACGCGCCC
CAAAAACCTCGTTCAATCA -> AAAAACCTCGTTCAATCAT
CAAAACGTGGGGTCGCCGC -> AAAACGTGGGGTCGCCGCC
CAAAACTTCAGCCAGAGCT -> AAAACTTCAGCCAGAGCTG
CAAAATAATGGTTCTCTCT -> AAAATAATGGTTCTCTCTG
CAAACACCAATGTTCTCGA -> AAACACCAATGTTCTCGAG
CAAACCCGCAATTATAGCG -> AAACCCGCAATTATAGCGG
CAAACGAGGGAATGCTGCT -> AAACGAGGGAATGCTGCTC
CAAAGCCGGGCTCAGCATC -> AAAGCCGGGCTCAGCATCC
CAAAGCCTCACCACATTCT -> AAAGCCTCACCACATTCTT
CAAAGGGCACACCTAACCT -> AAAGGGCACACCTAACCTT
CAAATCGATAAGAGATAGC -> AAATCGATAAGAGATAGCC
CAAATTTTGCCTCGCGTAT -> AAATTTTGCCTCGCGTATA
CAACAATGCATTGTCTTCT -> AACAATGCATTGTCTTCTC
CAACACAGAAGGCAGACTG -> AACACAGAAGGCAGACTGT
CAACCAGCCTACTCCAAGG -> AACCAGCCTACTCCAAGGA
CAACCGTAGCGCATGCAAA -> AACCGTAGCGCATGCAAAT
CAACTTTGGGGATTTGCAA -> AACTTTGGGGATTTGCAAA
CAAGCTGGCTCGTGTTTTA -> AAGCTGGCTCGTGTTTTAA
CAAGGACCATGCCACGGGA -> AAGGACCATGCCACGGGAC
CAAGGACTTCCCGCGGAGT -> AAGGACTTCCCGCGGAGTG
CAAGGAGAATACATAGTTC -> AAGGAGAATACATAGTTCC
CAAGGAGCCTGTCTCGTAA -> AAGGAGCCTGTCTCGTAAG
CAATAAAGACCAAAGCCTC -> AATAAAGACCAAAGCCTCA
CAATATCTCAGAGAGGTGG -> AATATCTCAGAGAGGTGGT
CAATCATTACTGTAGAGGA -> AATCATTACTGTAGAGGAT
CAATCTTAGGTGCAGCGAC -> AATCTTAGGTGCAGCGACT
CAATGCATTGTCTTCTCGA -> AATGCATTGTCTTCTCGAA
CAATGTTCTCGAGGATGCC -> AATGTTCTCGAGGATGCCC
CAATTAATGAGGTCCGTCA -> AATTAATGAGGTCCGTCAT
CAATTATAGCGGGCGTCCG -> AATTATAGCGGGCGTCCGG
CAATTTTCTCGGTTGTGTG -> AATTTTCTCGGTTGTGTGC
CACAAAATAATGGTTCTCT -> ACAAAATAATGGTTCTCTC
CACAACCAGCCTACTCCAA -> ACAACCAGCCTACTCCAAG
CACAACTTTGGGGATTTGC -> ACAACTTTGGGGATTTGCA
CACACCTAACCTTTCGATG -> ACACCTAACCTTTCGATGG
CACAGAAGGCAGACTGTCT -> ACAGAAGGCAGACTGTCTT
CACAGACCGATACCCAAGC -> ACAGACCGATACCCAAGCT
CACAGACCGGATCCACCTC -> ACAGACCGGATCCACCTCC
CACAGACGCAGGTCTTAAA -> ACAGACGCAGGTCTTAAAA
CACAGACTCTCATTCTCAT -> ACAGACTCTCATTCTCATT
CACAGCCATAGCGTCGATC -> ACAGCCATAGCGTCGATCT
CACAGGGCCCGCTAAAATG -> ACAGGGCCCGCTAAAATGC
CACAGTGATTAGTTACACA -> ACAGTGATTAGTTACACAA
CACATTCTTAACTTGAAGC -> ACATTCTTAACTTGAAGCG
CACCAAAGCCGGGCTCAGC -> ACCAAAGCCGGGCTCAGCA
CACCAATGTTCTCGAGGAT -> ACCAATGTTCTCGAGGATG
CACCACATTCTTAACTTGA -> ACCACATTCTTAACTTGAA
CACCATGCACCGACGTGTG -> ACCATGCACCGACGTGTGA
CACCCAAAACGTGGGGTCG -> ACCCAAAACGTGGGGTCGC
CACCCATCAATTAATGAGG -> ACCCATCAATTAATGAGGT
CACCCATGTATTCATTCGC -> ACCCATGTATTCATTCGCG
CACCCCTAGAAAGTTATTA -> ACCCCTAGAAAGTTATTAG
CACCGACGTGTGAATACCG -> ACCGACGTGTGAATACCGG
CACCGTATAAGTATGTGTG -> ACCGTATAAGTATGTGTGC
CACCTAACCTTTCGATGGG -> ACCTAACCTTTCGATGGGC
CACCTAGGGTACGTCCCCA -> ACCTAGGGTACGTCCCCAC
CACCTCCGTGTTTGTAAAT -> ACCTCCGTGTTTGTAAATT
CACGAGAGAAATACCGGCC -> ACGAGAGAAATACCGGCCG
CACGAGCCCAAGGAGCCTG -> ACGAGCCCAAGGAGCCTGT
CACGCGATCGTCTTAGTTC -> ACGCGATCGTCTTAGTTCC
CACGGAAGGGGTGGGCTGT -> ACGGAAGGGGTGGGCTGTA
CACGGCGTTGAACTTCCGC -> ACGGCGTTGAACTTCCGCA
CACGGGACAAACACCAATG -> ACGGGACAAACACCAATGT
CACGTAGTTCCGTCCGGAT -> ACGTAGTTCCGTCCGGATC
CACGTGACATTGACCCCAC -> ACGTGACATTGACCCCACG
CACTACTTTCGATCCATCA -> ACTACTTTCGATCCATCAT
CACTGGTTACATATCACCC -> ACTGGTTACATATCACCCA
CACTGTAGTAAGTGCGAGA -> ACTGTAGTAAGTGCGAGAG
CAGAAGGCAGACTGTCTTG -> AGAAGGCAGACTGTCTTGT
CAGACAGTCGCAGCATTAC -> AGACAGTCGCAGCATTACT
CAGACCGATACCCAAGCTG -> AGACCGATACCCAAGCTGG
CAGACCGGATCCACCTCCG -> AGACCGGATCCACCTCCGT
CAGACGCAGGTCTTAAAAC -> AGACGCAGGTCTTAAAACG
CAGACTATGGTGTTGTGTG -> AGACTATGGTGTTGTGTGC
CAGACTCTCATTCTCATTT -> AGACTCTCATTCTCATTTG
CAGACTGCTTCTAGCCTCG -> AGACTGCTTCTAGCCTCGG
CAGACTGTCTTGTACGATA -> AGACTGTCTTGTACGATAG
CAGAGAGGTGGTGGGGCCC -> AGAGAGGTGGTGGGGCCCC
CAGAGCTGGGCGGGAGCTT -> AGAGCTGGGCGGGAGCTTA
CAGATATACTTGCACGGCG -> AGATATACTTGCACGGCGT
CAGCAAGGACTTCCCGCGG -> AGCAAGGACTTCCCGCGGA
CAGCAGCAAGGACTTCCCG -> AGCAGCAAGGACTTCCCGC
CAGCATCCCAATAAAGACC -> AGCATCCCAATAAAGACCA
CAGCATTACTAGAAGCTAC -> AGCATTACTAGAAGCTACC
CAGCCAGAGCTGGGCGGGA -> AGCCAGAGCTGGGCGGGAG
CAGCCATAGCGTCGATCTC -> AGCCATAGCGTCGATCTCC
CAGCCGGAATAACTTTACT -> AGCCGGAATAACTTTACTG
CAGCCTACTCCAAGGACCA -> AGCCTACTCCAAGGACCAT
CAGCGACTCGCAGTACTCC -> AGCGACTCGCAGTACTCCG
CAGCGGTGGAACATGTCTG -> AGCGGTGGAACATGTCTGG
CAGCTCAGACAGTCGCAGC -> AGCTCAGACAGTCGCAGCA
CAGGGCCCGCTAAAATGCC -> AGGGCCCGCTAAAATGCCA
CAGGTCGATGAGTGGCATC -> AGGTCGATGAGTGGCATCA
CAGGTCTTAAAACGGTGTG -> AGGTCTTAAAACGGTGTGT
CAGGTCTTCTTCGACAACA -> AGGTCTTCTTCGACAACAA
CAGGTTCGCGATAGACCAT -> AGGTTCGCGATAGACCATG
CAGGTTGGCTTGACCGAGA -> AGGTTGGCTTGACCGAGAT
CAGTACTCCGCATACCTCA -> AGTACTCCGCATACCTCAT
CAGTAGCATATTCCGCCTT -> AGTAGCATATTCCGCCTTC
CAGTAGTTTGTTGCAGTGT -> AGTAGTTTGTTGCAGTGTA
CAGTCGCAGCATTACTAGA -> AGTCGCAGCATTACTAGAA
CAGTGATTAGTTACACAAC -> AGTGATTAGTTACACAACC
CAGTGTAATCAGATATACT -> AGTGTAATCAGATATACTT
CAGTTGATTCAATCTTAGG -> AGTTGATTCAATCTTAGGT
CAGTTTGGGGTGGGCATTA -> AGTTTGGGGTGGGCATTAC
CATAATATGAAGATCGAAT -> ATAATATGAAGATCGAATA
CATAATCGATGTGAGTTCT -> ATAATCGATGTGAGTTCTT
CATACCTCATGTGGACGAT -> ATACCTCATGTGGACGATT
CATACTGGTGGAACAGGTT -> ATACTGGTGGAACAGGTTC
CATAGCCACCCAAAACGTG -> ATAGCCACCCAAAACGTGG
CATAGCGTCGATCTCCGCA -> ATAGCGTCGATCTCCGCAA
CATAGTTCCGTCCGGATCC -> ATAGTTCCGTCCGGATCCA
CATATAAAGGCGGCTAGTG -> ATATAAAGGCGGCTAGTGG
CATATCACCCATCAATTAA -> ATATCACCCATCAATTAAT
CATATTAAGAGAGCGTCCA -> ATATTAAGAGAGCGTCCAC
CATATTCCGCCTTCTGCGT -> ATATTCCGCCTTCTGCGTG
CATCAATTAATGAGGTCCG -> ATCAATTAATGAGGTCCGT
CATCACGTAGTTCCGTCCG -> ATCACGTAGTTCCGTCCGG
CATCATATAAAGGCGGCTA -> ATCATATAAAGGCGGCTAG
CATCCCAATAAAGACCAAA -> ATCCCAATAAAGACCAAAG
CATCTAGCATTGTGGACGG -> ATCTAGCATTGTGGACGGC
CATCTTGAATTCGCGAGCT -> ATCTTGAATTCGCGAGCTT
CATGAGCGGCGGTACGAGG -> ATGAGCGGCGGTACGAGGG
CATGCAAATTTTGCCTCGC -> ATGCAAATTTTGCCTCGCG
CATGCACCGACGTGTGAAT -> ATGCACCGACGTGTGAATA
CATGCCACGGGACAAACAC -> ATGCCACGGGACAAACACC
CATGCTCGGACTCACAGCC -> ATGCTCGGACTCACAGCCA
CATGGCCAGACTGCTTCTA -> ATGGCCAGACTGCTTCTAG
CATGTATTCATTCGCGCCT -> ATGTATTCATTCGCGCCTA
CATGTCTGGATAAGACACA -> ATGTCTGGATAAGACACAA
CATGTGGACGATTGATTTT -> ATGTGGACGATTGATTTTG
CATTACAGGTTGGCTTGAC -> ATTACAGGTTGGCTTGACC
CATTACTAGAAGCTACCTT -> ATTACTAGAAGCTACCTTA
CATTACTGTAGAGGATGAT -> ATTACTGTAGAGGATGATA
CATTCGCGCCTAAACCGTC -> ATTCGCGCCTAAACCGTCG
CATTCTCATTTGCTTTACG -> ATTCTCATTTGCTTTACGG
CATTCTTAACTTGAAGCGA -> ATTCTTAACTTGAAGCGAT
CATTGACCCCACGCGATCG -> ATTGACCCCACGCGATCGT
CATTGAGCAAAAACCTCGT -> ATTGAGCAAAAACCTCGTT
CATTGATGGTCCCTGTGTG -> ATTGATGGTCCCTGTGTGC
CATTGTCTTCTCGAAGGGT -> ATTGTCTTCTCGAAGGGTT
CATTGTGGACGGCGAGTGT -> ATTGTGGACGGCGAGTGTA
CATTTCTTAGGAGAGAGGG -> ATTTCTTAGGAGAGAGGGT
CATTTGCTTTACGGCCTGA -> ATTTGCTTTACGGCCTGAC
CCAAAACGTGGGGTCGCCG -> CAAAACGTGGGGTCGCCGC
CCAAACCCGCAATTATAGC -> CAAACCCGCAATTATAGCG
CCAAAGCCGGGCTCAGCAT -> CAAAGCCGGGCTCAGCATC
CCAAAGCCTCACCACATTC -> CAAAGCCTCACCACATTCT
CCAAGCTGGCTCGTGTTTT -> CAAGCTGGCTCGTGTTTTA
CCAAGGACCATGCCACGGG -> CAAGGACCATGCCACGGGA
CCAAGGAGAATACATAGTT -> CAAGGAGAATACATAGTTC
CCAAGGAGCCTGTCTCGTA -> CAAGGAGCCTGTCTCGTAA
CCAATAAAGACCAAAGCCT -> CAATAAAGACCAAAGCCTC
CCAATGTTCTCGAGGATGC -> CAATGTTCTCGAGGATGCC
CCAATTTTCTCGGTTGTGT -> CAATTTTCTCGGTTGTGTG
CCACAACTTTGGGGATTTG -> CACAACTTTGGGGATTTGC
CCACATTCTTAACTTGAAG -> CACATTCTTAACTTGAAGC
CCACCCAAAACGTGGGGTC -> CACCCAAAACGTGGGGTCG
CCACCCCTAGAAAGTTATT -> CACCCCTAGAAAGTTATTA
CCACCGTATAAGTATGTGT -> CACCGTATAAGTATGTGTG
CCACCTAGGGTACGTCCCC -> CACCTAGGGTACGTCCCCA
CCACCTCCGTGTTTGTAAA -> CACCTCCGTGTTTGTAAAT
CCACGAGAGAAATACCGGC -> CACGAGAGAAATACCGGCC
CCACGCGATCGTCTTAGTT -> CACGCGATCGTCTTAGTTC
CCACGGAAGGGGTGGGCTG -> CACGGAAGGGGTGGGCTGT
CCACGGGACAAACACCAAT -> CACGGGACAAACACCAATG
CCACGTGACATTGACCCCA -> CACGTGACATTGACCCCAC
CCAGACTATGGTGTTGTGT -> CAGACTATGGTGTTGTGTG
CCAGACTGCTTCTAGCCTC -> CAGACTGCTTCTAGCCTCG
CCAGAGCTGGGCGGGAGCT -> CAGAGCTGGGCGGGAGCTT
CCAGCAGCAAGGACTTCCC -> CAGCAGCAAGGACTTCCCG
CCAGCCTACTCCAAGGACC -> CAGCCTACTCCAAGGACCA
CCAGTAGCATATTCCGCCT -> CAGTAGCATATTCCGCCTT
CCATAATCGATGTGAGTTC -> CATAATCGATGTGAGTTCT
CCATACTGGTGGAACAGGT -> CATACTGGTGGAACAGGTT
CCATAGCGTCGATCTCCGC -> CATAGCGTCGATCTCCGCA
CCATCAATTAATGAGGTCC -> CATCAATTAATGAGGTCCG
CCATCATATAAAGGCGGCT -> CATCATATAAAGGCGGCTA
CCATCTAGCATTGTGGACG -> CATCTAGCATTGTGGACGG
CCATGCACCGACGTGTGAA -> CATGCACCGACGTGTGAAT
CCATGCCACGGGACAAACA -> CATGCCACGGGACAAACAC
CCATGGCCAGACTGCTTCT -> CATGGCCAGACTGCTTCTA
CCATGTATTCATTCGCGCC -> CATGTATTCATTCGCGCCT
CCATTGAGCAAAAACCTCG -> CATTGAGCAAAAACCTCGT
CCATTGATGGTCCCTGTGT -> CATTGATGGTCCCTGTGTG
CCATTTCTTAGGAGAGAGG -> CATTTCTTAGGAGAGAGGG
CCCAAAACGTGGGGTCGCC -> CCAAAACGTGGGGTCGCCG
CCCAAGCTGGCTCGTGTTT -> CCAAGCTGGCTCGTGTTTT
CCCAAGGAGCCTGTCTCGT -> CCAAGGAGCCTGTCTCGTA
CCCAATAAAGACCAAAGCC -> CCAATAAAGACCAAAGCCT
CCCACGCGATCGTCTTAGT -> CCACGCGATCGTCTTAGTT
CCCACGGAAGGGGTGGGCT -> CCACGGAAGGGGTGGGCTG
CCCACGTGACATTGACCCC -> CCACGTGACATTGACCCCA
CCCAGCAGCAAGGACTTCC -> CCAGCAGCAAGGACTTCCC
CCCATACTGGTGGAACAGG -> CCATACTGGTGGAACAGGT
CCCATCAATTAATGAGGTC -> CCATCAATTAATGAGGTCC
CCCATGTATTCATTCGCGC -> CCATGTATTCATTCGCGCC
CCCATTTCTTAGGAGAGAG -> CCATTTCTTAGGAGAGAGG
CCCCACGCGATCGTCTTAG -> CCCACGCGATCGTCTTAGT
CCCCACGGAAGGGGTGGGC -> CCCACGGAAGGGGTGGGCT
CCCCACGTGACATTGACCC -> CCCACGTGACATTGACCCC
CCCCGAACTTTTGTGTTAG -> CCCGAACTTTTGTGTTAGC
CCCCGACGGGATAGTTCTA -> CCCGACGGGATAGTTCTAA
CCCCTAGAAAGTTATTAGC -> CCCTAGAAAGTTATTAGCC
CCCCTAGGCAGTAGTTTGT -> CCCTAGGCAGTAGTTTGTT
CCCGAACTTTTGTGTTAGC -> CCGAACTTTTGTGTTAGCG
CCCGACGGGATAGTTCTAA -> CCGACGGGATAGTTCTAAA
CCCGCAATTATAGCGGGCG -> CCGCAATTATAGCGGGCGT
CCCGCGGAGTGGGCGTCTT -> CCGCGGAGTGGGCGTCTTG
CCCGCTAAAATGCCAAGGA -> CCGCTAAAATGCCAAGGAG
CCCGGAGCACCCATGTATT -> CCGGAGCACCCATGTATTC
CCCTACATCTTGAATTCGC -> CCTACATCTTGAATTCGCG
CCCTAGAAAGTTATTAGCC -> CCTAGAAAGTTATTAGCCT
CCCTAGGCAGTAGTTTGTT -> CCTAGGCAGTAGTTTGTTG
CCCTGTAATAGTGACGAAT -> CCTGTAATAGTGACGAATA
CCCTGTGTGCCTCGGCACA -> CCTGTGTGCCTCGGCACAG
CCCTTCAGCTCAGACAGTC -> CCTTCAGCTCAGACAGTCG
CCGAACTTTTGTGTTAGCG -> CGAACTTTTGTGTTAGCGA
CCGACGGGATAGTTCTAAA -> CGACGGGATAGTTCTAAAC
CCGACGTGTGAATACCGGA -> CGACGTGTGAATACCGGAA
CCGAGATGAGTACCAGTAG -> CGAGATGAGTACCAGTAGC
CCGAGGTAATGTCTGTCCA -> CGAGGTAATGTCTGTCCAT
CCGATACCCAAGCTGGCTC -> CGATACCCAAGCTGGCTCG
CCGCAAAACTTCAGCCAGA -> CGCAAAACTTCAGCCAGAG
CCGCAATTATAGCGGGCGT -> CGCAATTATAGCGGGCGTC
CCGCATACCTCATGTGGAC -> CGCATACCTCATGTGGACG
CCGCCCTGTAATAGTGACG -> CGCCCTGTAATAGTGACGA
CCGCCTTCTGCGTGATCAA -> CGCCTTCTGCGTGATCAAT
CCGCGGAGTGGGCGTCTTG -> CGCGGAGTGGGCGTCTTGA
CCGCGTGAGAGCAGCGGTG -> CGCGTGAGAGCAGCGGTGG
CCGCTAAAATGCCAAGGAG -> CGCTAAAATGCCAAGGAGA
CCGGAATAACTTTACTGCT -> CGGAATAACTTTACTGCTA
CCGGAATTACTTCAACCGT -> CGGAATTACTTCAACCGTA
CCGGAGCACCCATGTATTC -> CGGAGCACCCATGTATTCA
CCGGATCCAATTTTCTCGG -> CGGATCCAATTTTCTCGGT
CCGGATCCACCGTATAAGT -> CGGATCCACCGTATAAGTA
CCGGATCCACCTCCGTGTT -> CGGATCCACCTCCGTGTTT
CCGGATCCAGACTATGGTG -> CGGATCCAGACTATGGTGT
CCGGATCCATTGATGGTCC -> CGGATCCATTGATGGTCCC
CCGGCCGAGGTAATGTCTG -> CGGCCGAGGTAATGTCTGT
CCGGGAAGACAGCCGGAAT -> CGGGAAGACAGCCGGAATA
CCGGGCTCAGCATCCCAAT -> CGGGCTCAGCATCCCAATA
CCGGTGGTTGCACAGGGCC -> CGGTGGTTGCACAGGGCCC
CCGTAGCGCATGCAAATTT -> CGTAGCGCATGCAAATTTT
CCGTATAAGTATGTGTGCC -> CGTATAAGTATGTGTGCCT
CCGTCATATTAAGAGAGCG -> CGTCATATTAAGAGAGCGT
CCGTCCGGATCCAATTTTC -> CGTCCGGATCCAATTTTCT
CCGTCCGGATCCACCGTAT -> CGTCCGGATCCACCGTATA
CCGTCCGGATCCAGACTAT -> CGTCCGGATCCAGACTATG
CCGTCCGGATCCATTGATG -> CGTCCGGATCCATTGATGG
CCGTCGGGAAATCACCAAA -> CGTCGGGAAATCACCAAAG
CCGTGCACTACTTTCGATC -> CGTGCACTACTTTCGATCC
CCGTGTTTGTAAATTCCCG -> CGTGTTTGTAAATTCCCGG
CCTAAACCGTCGGGAAATC -> CTAAACCGTCGGGAAATCA
CCTAACCTTTCGATGGGCT -> CTAACCTTTCGATGGGCTG
CCTACATCTTGAATTCGCG -> CTACATCTTGAATTCGCGA
CCTACTCCAAGGACCATGC -> CTACTCCAAGGACCATGCC
CCTAGAAAGTTATTAGCCT -> CTAGAAAGTTATTAGCCTA
CCTAGCCATAATCGATGTG -> CTAGCCATAATCGATGTGA
CCTAGGCAGTAGTTTGTTG -> CTAGGCAGTAGTTTGTTGC
CCTAGGGTACGTCCCCACG -> CTAGGGTACGTCCCCACGT
CCTCACCACATTCTTAACT -> CTCACCACATTCTTAACTT
CCTCATGTGGACGATTGAT -> CTCATGTGGACGATTGATT
CCTCCGTGTTTGTAAATTC -> CTCCGTGTTTGTAAATTCC
CCTCGCGTATAGGTGGGTA -> CTCGCGTATAGGTGGGTAA
CCTCGGCACAGACCGATAC -> CTCGGCACAGACCGATACC
CCTCGGCACAGACCGGATC -> CTCGGCACAGACCGGATCC
CCTCGGCACAGACGCAGGT -> CTCGGCACAGACGCAGGTC
CCTCGGCACAGACTCTCAT -> CTCGGCACAGACTCTCATT
CCTCGGGTATTATCACTGT -> CTCGGGTATTATCACTGTA
CCTCGGTCTGCGTTTTGCA -> CTCGGTCTGCGTTTTGCAA
CCTCGTCGGACCCCGACGG -> CTCGTCGGACCCCGACGGG
CCTCGTTCAATCATTACTG -> CTCGTTCAATCATTACTGT
CCTCTACGAAGTGGCACCA -> CTCTACGAAGTGGCACCAT
CCTGACCTCTACGAAGTGG -> CTGACCTCTACGAAGTGGC
CCTGTAATAGTGACGAATA -> CTGTAATAGTGACGAATAT
CCTGTCTCGTAAGTACAGT -> CTGTCTCGTAAGTACAGTT
CCTGTGTAACCGTGCACTA -> CTGTGTAACCGTGCACTAC
CCTGTGTAGTGCGACCTGT -> CTGTGTAGTGCGACCTGTG
CCTGTGTGCCTCGGCACAG -> CTGTGTGCCTCGGCACAGA
CCTGTTCCACGAGAGAAAT -> CTGTTCCACGAGAGAAATA
CCTTATGATCTCCAAACCC -> CTTATGATCTCCAAACCCG
CCTTCAGCTCAGACAGTCG -> CTTCAGCTCAGACAGTCGC
CCTTCTGCGTGATCAATAT -> CTTCTGCGTGATCAATATC
CCTTTCGATGGGCTGCTAA -> CTTTCGATGGGCTGCTAAG
CGAACTTTTGTGTTAGCGA -> GAACTTTTGTGTTAGCGAG
CGAAGGGTTATGGAGAAAG -> GAAGGGTTATGGAGAAAGT
CGAAGTGGCACCATGCACC -> GAAGTGGCACCATGCACCG
CGAATAGAAACGTTATCGT -> GAATAGAAACGTTATCGTG
CGAATATCAACACAGAAGG -> GAATATCAACACAGAAGGC
CGACAACAATGCATTGTCT -> GACAACAATGCATTGTCTT
CGACCTGTGTAACCGTGCA -> GACCTGTGTAACCGTGCAC
CGACGGGATAGTTCTAAAC -> GACGGGATAGTTCTAAACT
CGACGTGTGAATACCGGAA -> GACGTGTGAATACCGGAAT
CGACTCGCAGTACTCCGCA -> GACTCGCAGTACTCCGCAT
CGAGAGAAATACCGGCCGA -> GAGAGAAATACCGGCCGAG
CGAGAGGTCACAGTGATTA -> GAGAGGTCACAGTGATTAG
CGAGATATTACTCCCTACA -> GAGATATTACTCCCTACAT
CGAGATGAGTACCAGTAGC -> GAGATGAGTACCAGTAGCA
CGAGCCCAAGGAGCCTGTC -> GAGCCCAAGGAGCCTGTCT
CGAGCTGGTATAATTGATC -> GAGCTGGTATAATTGATCT
CGAGCTTTCTACGCTGATG -> GAGCTTTCTACGCTGATGA
CGAGGATGCCCTTCAGCTC -> GAGGATGCCCTTCAGCTCA
CGAGGGAATGCTGCTCCCA -> GAGGGAATGCTGCTCCCAG
CGAGGGTCCTGTGTAGTGC -> GAGGGTCCTGTGTAGTGCG
CGAGGTAATGTCTGTCCAT -> GAGGTAATGTCTGTCCATC
CGAGTAATCCCCTAGGCAG -> GAGTAATCCCCTAGGCAGT
CGAGTGCGAGCTGGTATAA -> GAGTGCGAGCTGGTATAAT
CGAGTGTACTACGGGAAGT -> GAGTGTACTACGGGAAGTA
CGATAAGAGATAGCCGGTG -> GATAAGAGATAGCCGGTGG
CGATACCCAAGCTGGCTCG -> GATACCCAAGCTGGCTCGT
CGATAGACCATGGCCAGAC -> GATAGACCATGGCCAGACT
CGATAGCAGGTCGATGAGT -> GATAGCAGGTCGATGAGTG
CGATCCATCATATAAAGGC -> GATCCATCATATAAAGGCG
CGATCGAGTGCGAGCTGGT -> GATCGAGTGCGAGCTGGTA
CGATCGATCTCCTCGGGTA -> GATCGATCTCCTCGGGTAT
CGATCGTCTTAGTTCCGTC -> GATCGTCTTAGTTCCGTCC
CGATCTCCGCAAAACTTCA -> GATCTCCGCAAAACTTCAG
CGATCTCCTCGGGTATTAT -> GATCTCCTCGGGTATTATC
CGATGAGTGGCATCACGTA -> GATGAGTGGCATCACGTAG
CGATGGGCTGCTAAGTCGA -> GATGGGCTGCTAAGTCGAT
CGATGTGAGTTCTTACATA -> GATGTGAGTTCTTACATAA
CGATTGATTTTGCGGTGAA -> GATTGATTTTGCGGTGAAC
CGATTTCATGCTCGGACTC -> GATTTCATGCTCGGACTCA
CGCAAAACTTCAGCCAGAG -> GCAAAACTTCAGCCAGAGC
CGCAATTATAGCGGGCGTC -> GCAATTATAGCGGGCGTCC
CGCAGCATTACTAGAAGCT -> GCAGCATTACTAGAAGCTA
CGCAGGTCTTAAAACGGTG -> GCAGGTCTTAAAACGGTGT
CGCAGTACTCCGCATACCT -> GCAGTACTCCGCATACCTC
CGCATACCTCATGTGGACG -> GCATACCTCATGTGGACGA
CGCATGCAAATTTTGCCTC -> GCATGCAAATTTTGCCTCG
CGCCCATTTCTTAGGAGAG -> GCCCATTTCTTAGGAGAGA
CGCCCTGTAATAGTGACGA -> GCCCTGTAATAGTGACGAA
CGCCGCCCTGTAATAGTGA -> GCCGCCCTGTAATAGTGAC
CGCCTAAACCGTCGGGAAA -> GCCTAAACCGTCGGGAAAT
CGCCTTCTGCGTGATCAAT -> GCCTTCTGCGTGATCAATA
CGCGAGCTTTCTACGCTGA -> GCGAGCTTTCTACGCTGAT
CGCGATAGACCATGGCCAG -> GCGATAGACCATGGCCAGA
CGCGATCGTCTTAGTTCCG -> GCGATCGTCTTAGTTCCGT
CGCGCCCATTTCTTAGGAG -> GCGCCCATTTCTTAGGAGA
CGCGCCTAAACCGTCGGGA -> GCGCCTAAACCGTCGGGAA
CGCGGAGTGGGCGTCTTGA -> GCGGAGTGGGCGTCTTGAC
CGCGTATAGGTGGGTAAGC -> GCGTATAGGTGGGTAAGCA
CGCGTGAGAGCAGCGGTGG -> GCGTGAGAGCAGCGGTGGA
CGCTAAAATGCCAAGGAGA -> GCTAAAATGCCAAGGAGAA
CGCTGATGAATGGCTCAAA -> GCTGATGAATGGCTCAAAT
CGGAAGGGGTGGGCTGTAC -> GGAAGGGGTGGGCTGTACT
CGGAATAACTTTACTGCTA -> GGAATAACTTTACTGCTAA
CGGAATTACTTCAACCGTA -> GGAATTACTTCAACCGTAG
CGGACATAGCCACCCAAAA -> GGACATAGCCACCCAAAAC
CGGACCCCGACGGGATAGT -> GGACCCCGACGGGATAGTT
CGGACTCACAGCCATAGCG -> GGACTCACAGCCATAGCGT
CGGAGCACCCATGTATTCA -> GGAGCACCCATGTATTCAT
CGGAGTGGGCGTCTTGACG -> GGAGTGGGCGTCTTGACGG
CGGATCCAATTTTCTCGGT -> GGATCCAATTTTCTCGGTT
CGGATCCACCGTATAAGTA -> GGATCCACCGTATAAGTAT
CGGATCCACCTCCGTGTTT -> GGATCCACCTCCGTGTTTG
CGGATCCAGACTATGGTGT -> GGATCCAGACTATGGTGTT
CGGATCCATTGATGGTCCC -> GGATCCATTGATGGTCCCT
CGGCACAGACCGATACCCA -> GGCACAGACCGATACCCAA
CGGCACAGACCGGATCCAC -> GGCACAGACCGGATCCACC
CGGCACAGACGCAGGTCTT -> GGCACAGACGCAGGTCTTA
CGGCACAGACTCTCATTCT -> GGCACAGACTCTCATTCTC
CGGCCGAGGTAATGTCTGT -> GGCCGAGGTAATGTCTGTC
CGGCCGCGTGAGAGCAGCG -> GGCCGCGTGAGAGCAGCGG
CGGCCTGACCTCTACGAAG -> GGCCTGACCTCTACGAAGT
CGGCGAGTGTACTACGGGA -> GGCGAGTGTACTACGGGAA
CGGCGGTACGAGGGTCCTG -> GGCGGTACGAGGGTCCTGT
CGGCGTTGAACTTCCGCAA -> GGCGTTGAACTTCCGCAAT
CGGCTAGTGGCGGACATAG -> GGCTAGTGGCGGACATAGC
CGGGAAATCACCAAAGCCG -> GGGAAATCACCAAAGCCGG
CGGGAAGACAGCCGGAATA -> GGGAAGACAGCCGGAATAA
CGGGAAGTACGTAGTGTAC -> GGGAAGTACGTAGTGTACT
CGGGACAAACACCAATGTT -> GGGACAAACACCAATGTTC
CGGGAGCTTATCATGAGCG -> GGGAGCTTATCATGAGCGG
CGGGATAGTTCTAAACTTT -> GGGATAGTTCTAAACTTTC
CGGGCGTCCGGGAAGACAG -> GGGCGTCCGGGAAGACAGC
CGGGCTCAGCATCCCAATA -> GGGCTCAGCATCCCAATAA
CGGGTATTATCACTGTAGT -> GGGTATTATCACTGTAGTA
CGGTACGAGGGTCCTGTGT -> GGTACGAGGGTCCTGTGTA
CGGTCTGCGTTTTGCAAAG -> GGTCTGCGTTTTGCAAAGG
CGGTGAACGCGCCCATTTC -> GGTGAACGCGCCCATTTCT
CGGTGGAACATGTCTGGAT -> GGTGGAACATGTCTGGATA
CGGTGGTTGCACAGGGCCC -> GGTGGTTGCACAGGGCCCG
CGGTGTGTGAAAAGTCCCA -> GGTGTGTGAAAAGTCCCAT
CGGTTGTGTGCCTCGGCAC -> GGTTGTGTGCCTCGGCACA
CGTAAGTACAGTTGATTCA -> GTAAGTACAGTTGATTCAA
CGTAGCGCATGCAAATTTT -> GTAGCGCATGCAAATTTTG
CGTAGTGTACTAGTTCCGT -> GTAGTGTACTAGTTCCGTC
CGTAGTTCCGTCCGGATCC -> GTAGTTCCGTCCGGATCCA
CGTATAAGTATGTGTGCCT -> GTATAAGTATGTGTGCCTC
CGTATAGGTGGGTAAGCAG -> GTATAGGTGGGTAAGCAGG
CGTCATATTAAGAGAGCGT -> GTCATATTAAGAGAGCGTC
CGTCCACCCCTAGAAAGTT -> GTCCACCCCTAGAAAGTTA
CGTCCCCACGTGACATTGA -> GTCCCCACGTGACATTGAC
CGTCCGGATCCAATTTTCT -> GTCCGGATCCAATTTTCTC
CGTCCGGATCCACCGTATA -> GTCCGGATCCACCGTATAA
CGTCCGGATCCAGACTATG -> GTCCGGATCCAGACTATGG
CGTCCGGATCCATTGATGG -> GTCCGGATCCATTGATGGT
CGTCCGGGAAGACAGCCGG -> GTCCGGGAAGACAGCCGGA
CGTCGATCTCCGCAAAACT -> GTCGATCTCCGCAAAACTT
CGTCGGACCCCGACGGGAT -> GTCGGACCCCGACGGGATA
CGTCGGGAAATCACCAAAG -> GTCGGGAAATCACCAAAGC
CGTCTTAGTTCCGTCCGGA -> GTCTTAGTTCCGTCCGGAT
CGTCTTGACGGCCGCGTGA -> GTCTTGACGGCCGCGTGAG
CGTGAAACCCCACGGAAGG -> GTGAAACCCCACGGAAGGG
CGTGACATTGACCCCACGC -> GTGACATTGACCCCACGCG
CGTGAGAGCAGCGGTGGAA -> GTGAGAGCAGCGGTGGAAC
CGTGATCAATATCTCAGAG -> GTGATCAATATCTCAGAGA
CGTGCACTACTTTCGATCC -> GTGCACTACTTTCGATCCA
CGTGGACGATCGATCTCCT -> GTGGACGATCGATCTCCTC
CGTGGGGTCGCCGCCCTGT -> GTGGGGTCGCCGCCCTGTA
CGTGTGAATACCGGAATTA -> GTGTGAATACCGGAATTAC
CGTGTTTGTAAATTCCCGG -> GTGTTTGTAAATTCCCGGA
CGTGTTTTAAAGCCACAAC -> GTGTTTTAAAGCCACAACT
CGTTATCGTGAAACCCCAC -> GTTATCGTGAAACCCCACG
CGTTCAATCATTACTGTAG -> GTTCAATCATTACTGTAGA
CGTTTTGCAAAGGGCACAC -> GTTTTGCAAAGGGCACACC
CTAAAAAGCAGTTTGGGGT -> TAAAAAGCAGTTTGGGGTG
CTAAAATGCCAAGGAGAAT -> TAAAATGCCAAGGAGAATA
CTAAACCGTCGGGAAATCA -> TAAACCGTCGGGAAATCAC
CTAAACTTTCCACCTAGGG -> TAAACTTTCCACCTAGGGT
CTAACCTTTCGATGGGCTG -> TAACCTTTCGATGGGCTGC
CTAAGTCGATCGAGTGCGA -> TAAGTCGATCGAGTGCGAG
CTACATCTTGAATTCGCGA -> TACATCTTGAATTCGCGAG
CTACCTTATGATCTCCAAA -> TACCTTATGATCTCCAAAC
CTACGAAGTGGCACCATGC -> TACGAAGTGGCACCATGCA
CTACGCTGATGAATGGCTC -> TACGCTGATGAATGGCTCA
CTACGGGAAGTACGTAGTG -> TACGGGAAGTACGTAGTGT
CTACTCCAAGGACCATGCC -> TACTCCAAGGACCATGCCA
CTACTTTCGATCCATCATA -> TACTTTCGATCCATCATAT
CTAGAAAGTTATTAGCCTA -> TAGAAAGTTATTAGCCTAG
CTAGAAGCTACCTTATGAT -> TAGAAGCTACCTTATGATC
CTAGCATTGTGGACGGCGA -> TAGCATTGTGGACGGCGAG
CTAGCCATAATCGATGTGA -> TAGCCATAATCGATGTGAG
CTAGCCTCGGTCTGCGTTT -> TAGCCTCGGTCTGCGTTTT
CTAGGCAGTAGTTTGTTGC -> TAGGCAGTAGTTTGTTGCA
CTAGGGTACGTCCCCACGT -> TAGGGTACGTCCCCACGTG
CTAGTGGCGGACATAGCCA -> TAGTGGCGGACATAGCCAC
CTAGTTCCGTCCGGATCCA -> TAGTTCCGTCCGGATCCAC
CTATATTATTATTGGCACG -> TATATTATTATTGGCACGA
CTATGGTGTTGTGTGCCTC -> TATGGTGTTGTGTGCCTCG
CTCAAATCGATAAGAGATA -> TCAAATCGATAAGAGATAG
CTCACAGCCATAGCGTCGA -> TCACAGCCATAGCGTCGAT
CTCACCACATTCTTAACTT -> TCACCACATTCTTAACTTG
CTCAGACAGTCGCAGCATT -> TCAGACAGTCGCAGCATTA
CTCAGAGAGGTGGTGGGGC -> TCAGAGAGGTGGTGGGGCC
CTCAGCATCCCAATAAAGA -> TCAGCATCCCAATAAAGAC
CTCATGTGGACGATTGATT -> TCATGTGGACGATTGATTT
CTCATTCTCATTTGCTTTA -> TCATTCTCATTTGCTTTAC
CTCATTTGCTTTACGGCCT -> TCATTTGCTTTACGGCCTG
CTCCAAACCCGCAATTATA -> TCCAAACCCGCAATTATAG
CTCCAAGGACCATGCCACG -> TCCAAGGACCATGCCACGG
CTCCATTGAGCAAAAACCT -> TCCATTGAGCAAAAACCTC
CTCCCAGCAGCAAGGACTT -> TCCCAGCAGCAAGGACTTC
CTCCCTACATCTTGAATTC -> TCCCTACATCTTGAATTCG
CTCCGCAAAACTTCAGCCA -> TCCGCAAAACTTCAGCCAG
CTCCGCATACCTCATGTGG -> TCCGCATACCTCATGTGGA
CTCCGTGTTTGTAAATTCC -> TCCGTGTTTGTAAATTCCC
CTCCTCGGGTATTATCACT -> TCCTCGGGTATTATCACTG
CTCGAAGGGTTATGGAGAA -> TCGAAGGGTTATGGAGAAA
CTCGAGGATGCCCTTCAGC -> TCGAGGATGCCCTTCAGCT
CTCGCAGTACTCCGCATAC -> TCGCAGTACTCCGCATACC
CTCGCGTATAGGTGGGTAA -> TCGCGTATAGGTGGGTAAG
CTCGGACTCACAGCCATAG -> TCGGACTCACAGCCATAGC
CTCGGCACAGACCGATACC -> TCGGCACAGACCGATACCC
CTCGGCACAGACCGGATCC -> TCGGCACAGACCGGATCCA
CTCGGCACAGACGCAGGTC -> TCGGCACAGACGCAGGTCT
CTCGGCACAGACTCTCATT -> TCGGCACAGACTCTCATTC
CTCGGGTATTATCACTGTA -> TCGGGTATTATCACTGTAG
CTCGGTCTGCGTTTTGCAA -> TCGGTCTGCGTTTTGCAAA
CTCGGTTGTGTGCCTCGGC -> TCGGTTGTGTGCCTCGGCA
CTCGTAAGTACAGTTGATT -> TCGTAAGTACAGTTGATTC
CTCGTCGGACCCCGACGGG -> TCGTCGGACCCCGACGGGA
CTCGTGTTTTAAAGCCACA -> TCGTGTTTTAAAGCCACAA
CTCGTTCAATCATTACTGT -> TCGTTCAATCATTACTGTA
CTCTACGAAGTGGCACCAT -> TCTACGAAGTGGCACCATG
CTCTCATTCTCATTTGCTT -> TCTCATTCTCATTTGCTTT
CTCTCTGAATACGTGGACG -> TCTCTGAATACGTGGACGA
CTCTGAATACGTGGACGAT -> TCTGAATACGTGGACGATC
CTGAATACGAGATATTACT -> TGAATACGAGATATTACTC
CTGAATACGTGGACGATCG -> TGAATACGTGGACGATCGA
CTGACCTCTACGAAGTGGC -> TGACCTCTACGAAGTGGCA
CTGATGAATGGCTCAAATC -> TGATGAATGGCTCAAATCG
CTGCGTGATCAATATCTCA -> TGCGTGATCAATATCTCAG
CTGCGTTTTGCAAAGGGCA -> TGCGTTTTGCAAAGGGCAC
CTGCTAAAAAGCAGTTTGG -> TGCTAAAAAGCAGTTTGGG
CTGCTAAGTCGATCGAGTG -> TGCTAAGTCGATCGAGTGC
CTGCTCCCAGCAGCAAGGA -> TGCTCCCAGCAGCAAGGAC
CTGCTTCTAGCCTCGGTCT -> TGCTTCTAGCCTCGGTCTG
CTGGATAAGACACAAAATA -> TGGATAAGACACAAAATAA
CTGGCTCGTGTTTTAAAGC -> TGGCTCGTGTTTTAAAGCC
CTGGGCGGGAGCTTATCAT -> TGGGCGGGAGCTTATCATG
CTGGTATAATTGATCTTGG -> TGGTATAATTGATCTTGGC
CTGGTGGAACAGGTTCGCG -> TGGTGGAACAGGTTCGCGA
CTGGTTACATATCACCCAT -> TGGTTACATATCACCCATC
CTGTAATAGTGACGAATAT -> TGTAATAGTGACGAATATC
CTGTACTCCATTGAGCAAA -> TGTACTCCATTGAGCAAAA
CTGTAGAGGATGATATTGT -> TGTAGAGGATGATATTGTT
CTGTAGTAAGTGCGAGAGG -> TGTAGTAAGTGCGAGAGGT
CTGTCCATCTAGCATTGTG -> TGTCCATCTAGCATTGTGG
CTGTCTCGTAAGTACAGTT -> TGTCTCGTAAGTACAGTTG
CTGTCTTGTACGATAGCAG -> TGTCTTGTACGATAGCAGG
CTGTGTAACCGTGCACTAC -> TGTGTAACCGTGCACTACT
CTGTGTAGTGCGACCTGTG -> TGTGTAGTGCGACCTGTGT
CTGTGTGCCTCGGCACAGA -> TGTGTGCCTCGGCACAGAC
CTGTTCCACGAGAGAAATA -> TGTTCCACGAGAGAAATAC
CTTAAAACGGTGTGTGAAA -> TTAAAACGGTGTGTGAAAA
CTTAACTTGAAGCGATTTC -> TTAACTTGAAGCGATTTCA
CTTACATAATATGAAGATC -> TTACATAATATGAAGATCG
CTTAGGAGAGAGGGTTTTG -> TTAGGAGAGAGGGTTTTGA
CTTAGGTGCAGCGACTCGC -> TTAGGTGCAGCGACTCGCA
CTTAGTTCCGTCCGGATCC -> TTAGTTCCGTCCGGATCCA
CTTATCATGAGCGGCGGTA -> TTATCATGAGCGGCGGTAC
CTTATGATCTCCAAACCCG -> TTATGATCTCCAAACCCGC
CTTCAACCGTAGCGCATGC -> TTCAACCGTAGCGCATGCA
CTTCAGCCAGAGCTGGGCG -> TTCAGCCAGAGCTGGGCGG
CTTCAGCTCAGACAGTCGC -> TTCAGCTCAGACAGTCGCA
CTTCCCGCGGAGTGGGCGT -> TTCCCGCGGAGTGGGCGTC
CTTCGACAACAATGCATTG -> TTCGACAACAATGCATTGT
CTTCTAGCCTCGGTCTGCG -> TTCTAGCCTCGGTCTGCGT
CTTCTCGAAGGGTTATGGA -> TTCTCGAAGGGTTATGGAG
CTTCTGCGTGATCAATATC -> TTCTGCGTGATCAATATCT
CTTCTTCGACAACAATGCA -> TTCTTCGACAACAATGCAT
CTTGAAGCGATTTCATGCT -> TTGAAGCGATTTCATGCTC
CTTGAATTCGCGAGCTTTC -> TTGAATTCGCGAGCTTTCT
CTTGACCGAGATGAGTACC -> TTGACCGAGATGAGTACCA
CTTGACGGCCGCGTGAGAG -> TTGACGGCCGCGTGAGAGC
CTTGCACGGCGTTGAACTT -> TTGCACGGCGTTGAACTTC
CTTGGCTGAATACGAGATA -> TTGGCTGAATACGAGATAT
CTTGTACGATAGCAGGTCG -> TTGTACGATAGCAGGTCGA
CTTTACGGCCTGACCTCTA -> TTTACGGCCTGACCTCTAC
CTTTACTGCTAAAAAGCAG -> TTTACTGCTAAAAAGCAGT
CTTTCCACCTAGGGTACGT -> TTTCCACCTAGGGTACGTC
CTTTCGATCCATCATATAA -> TTTCGATCCATCATATAAA
CTTTCGATGGGCTGCTAAG -> TTTCGATGGGCTGCTAAGT
CTTTCTACGCTGATGAATG -> TTTCTACGCTGATGAATGG
CTTTGGGGATTTGCAAACG -> TTTGGGGATTTGCAAACGA
CTTTTGTGTTAGCGAGTAA -> TTTTGTGTTAGCGAGTAAT
GAAAAGTCCCATACTGGTG -> AAAAGTCCCATACTGGTGG
GAAACCCCACGGAAGGGGT -> AAACCCCACGGAAGGGGTG
GAAACGTTATCGTGAAACC -> AAACGTTATCGTGAAACCC
GAAAGTGCCTGTTCCACGA -> AAAGTGCCTGTTCCACGAG
GAAAGTTATTAGCCTAGCC -> AAAGTTATTAGCCTAGCCA
GAAATACCGGCCGAGGTAA -> AAATACCGGCCGAGGTAAT
GAAATCACCAAAGCCGGGC -> AAATCACCAAAGCCGGGCT
GAACAGGTTCGCGATAGAC -> AACAGGTTCGCGATAGACC
GAACATGTCTGGATAAGAC -> AACATGTCTGGATAAGACA
GAACGCGCCCATTTCTTAG -> AACGCGCCCATTTCTTAGG
GAACTTTTGTGTTAGCGAG -> AACTTTTGTGTTAGCGAGT
GAAGACAGCCGGAATAACT -> AAGACAGCCGGAATAACTT
GAAGATCGAATAGAAACGT -> AAGATCGAATAGAAACGTT
GAAGCGATTTCATGCTCGG -> AAGCGATTTCATGCTCGGA
GAAGCTACCTTATGATCTC -> AAGCTACCTTATGATCTCC
GAAGGCAGACTGTCTTGTA -> AAGGCAGACTGTCTTGTAC
GAAGGGGTGGGCTGTACTC -> AAGGGGTGGGCTGTACTCC
GAAGGGTTATGGAGAAAGT -> AAGGGTTATGGAGAAAGTG
GAAGTACGTAGTGTACTAG -> AAGTACGTAGTGTACTAGT
GAAGTGGCACCATGCACCG -> AAGTGGCACCATGCACCGA
GAATAACTTTACTGCTAAA -> AATAACTTTACTGCTAAAA
GAATACATAGTTCCGTCCG -> AATACATAGTTCCGTCCGG
GAATACCGGAATTACTTCA -> AATACCGGAATTACTTCAA
GAATACGAGATATTACTCC -> AATACGAGATATTACTCCC
GAATACGTGGACGATCGAT -> AATACGTGGACGATCGATC
GAATAGAAACGTTATCGTG -> AATAGAAACGTTATCGTGA
GAATATCAACACAGAAGGC -> AATATCAACACAGAAGGCA
GAATGCTGCTCCCAGCAGC -> AATGCTGCTCCCAGCAGCA
GAATGGCTCAAATCGATAA -> AATGGCTCAAATCGATAAG
GAATTACTTCAACCGTAGC -> AATTACTTCAACCGTAGCG
GAATTCGCGAGCTTTCTAC -> AATTCGCGAGCTTTCTACG
GACAAACACCAATGTTCTC -> ACAAACACCAATGTTCTCG
GACAACAATGCATTGTCTT -> ACAACAATGCATTGTCTTC
GACACAAAATAATGGTTCT -> ACACAAAATAATGGTTCTC
GACAGCCGGAATAACTTTA -> ACAGCCGGAATAACTTTAC
GACAGTCGCAGCATTACTA -> ACAGTCGCAGCATTACTAG
GACATAGCCACCCAAAACG -> ACATAGCCACCCAAAACGT
GACATTGACCCCACGCGAT -> ACATTGACCCCACGCGATC
GACCAAAGCCTCACCACAT -> ACCAAAGCCTCACCACATT
GACCATGCCACGGGACAAA -> ACCATGCCACGGGACAAAC
GACCATGGCCAGACTGCTT -> ACCATGGCCAGACTGCTTC
GACCCCACGCGATCGTCTT -> ACCCCACGCGATCGTCTTA
GACCCCGACGGGATAGTTC -> ACCCCGACGGGATAGTTCT
GACCGAGATGAGTACCAGT -> ACCGAGATGAGTACCAGTA
GACCGATACCCAAGCTGGC -> ACCGATACCCAAGCTGGCT
GACCGGATCCACCTCCGTG -> ACCGGATCCACCTCCGTGT
GACCTCTACGAAGTGGCAC -> ACCTCTACGAAGTGGCACC
GACCTGTGTAACCGTGCAC -> ACCTGTGTAACCGTGCACT
GACGAATATCAACACAGAA -> ACGAATATCAACACAGAAG
GACGATCGATCTCCTCGGG -> ACGATCGATCTCCTCGGGT
GACGATTGATTTTGCGGTG -> ACGATTGATTTTGCGGTGA
GACGCAGGTCTTAAAACGG -> ACGCAGGTCTTAAAACGGT
GACGGCCGCGTGAGAGCAG -> ACGGCCGCGTGAGAGCAGC
GACGGCGAGTGTACTACGG -> ACGGCGAGTGTACTACGGG
GACGGGATAGTTCTAAACT -> ACGGGATAGTTCTAAACTT
GACGTGTGAATACCGGAAT -> ACGTGTGAATACCGGAATT
GACTATGGTGTTGTGTGCC -> ACTATGGTGTTGTGTGCCT
GACTCACAGCCATAGCGTC -> ACTCACAGCCATAGCGTCG
GACTCGCAGTACTCCGCAT -> ACTCGCAGTACTCCGCATA
GACTCTCATTCTCATTTGC -> ACTCTCATTCTCATTTGCT
GACTGCTTCTAGCCTCGGT -> ACTGCTTCTAGCCTCGGTC
GACTGTCTTGTACGATAGC -> ACTGTCTTGTACGATAGCA
GACTTCCCGCGGAGTGGGC -> ACTTCCCGCGGAGTGGGCG
GAGAAAGTGCCTGTTCCAC -> AGAAAGTGCCTGTTCCACG
GAGAAATACCGGCCGAGGT -> AGAAATACCGGCCGAGGTA
GAGAATACATAGTTCCGTC -> AGAATACATAGTTCCGTCC
GAGAGAAATACCGGCCGAG -> AGAGAAATACCGGCCGAGG
GAGAGAGGGTTTTGAGTAC -> AGAGAGGGTTTTGAGTACA
GAGAGCAGCGGTGGAACAT -> AGAGCAGCGGTGGAACATG
GAGAGCGTCCACCCCTAGA -> AGAGCGTCCACCCCTAGAA
GAGAGGGTTTTGAGTACAC -> AGAGGGTTTTGAGTACACT
GAGAGGTCACAGTGATTAG -> AGAGGTCACAGTGATTAGT
GAGAGGTGGTGGGGCCCCG -> AGAGGTGGTGGGGCCCCGA
GAGATAGCCGGTGGTTGCA -> AGATAGCCGGTGGTTGCAC
GAGATATTACTCCCTACAT -> AGATATTACTCCCTACATC
GAGATGAGTACCAGTAGCA -> AGATGAGTACCAGTAGCAT
GAGCAAAAACCTCGTTCAA -> AGCAAAAACCTCGTTCAAT
GAGCACCCATGTATTCATT -> AGCACCCATGTATTCATTC
GAGCAGCGGTGGAACATGT -> AGCAGCGGTGGAACATGTC
GAGCCCAAGGAGCCTGTCT -> AGCCCAAGGAGCCTGTCTC
GAGCCTGTCTCGTAAGTAC -> AGCCTGTCTCGTAAGTACA
GAGCGGCGGTACGAGGGTC -> AGCGGCGGTACGAGGGTCC
GAGCGTCCACCCCTAGAAA -> AGCGTCCACCCCTAGAAAG
GAGCTGGGCGGGAGCTTAT -> AGCTGGGCGGGAGCTTATC
GAGCTGGTATAATTGATCT -> AGCTGGTATAATTGATCTT
GAGCTTATCATGAGCGGCG -> AGCTTATCATGAGCGGCGG
GAGCTTTCTACGCTGATGA -> AGCTTTCTACGCTGATGAA
GAGGATGATATTGTTCCTC -> AGGATGATATTGTTCCTCG
GAGGATGCCCTTCAGCTCA -> AGGATGCCCTTCAGCTCAG
GAGGGAATGCTGCTCCCAG -> AGGGAATGCTGCTCCCAGC
GAGGGTCCTGTGTAGTGCG -> AGGGTCCTGTGTAGTGCGA
GAGGGTTTTGAGTACACTG -> AGGGTTTTGAGTACACTGG
GAGGTAATGTCTGTCCATC -> AGGTAATGTCTGTCCATCT
GAGGTCACAGTGATTAGTT -> AGGTCACAGTGATTAGTTA
GAGGTCCGTCATATTAAGA -> AGGTCCGTCATATTAAGAG
GAGGTGGTGGGGCCCCGAA -> AGGTGGTGGGGCCCCGAAC
GAGTAATCCCCTAGGCAGT -> AGTAATCCCCTAGGCAGTA
GAGTACACTGGTTACATAT -> AGTACACTGGTTACATATC
GAGTACCAGTAGCATATTC -> AGTACCAGTAGCATATTCC
GAGTGCGAGCTGGTATAAT -> AGTGCGAGCTGGTATAATT
GAGTGGCATCACGTAGTTC -> AGTGGCATCACGTAGTTCC
GAGTGGGCGTCTTGACGGC -> AGTGGGCGTCTTGACGGCC
GAGTGTACTACGGGAAGTA -> AGTGTACTACGGGAAGTAC
GAGTTCTTACATAATATGA -> AGTTCTTACATAATATGAA
GATAAGACACAAAATAATG -> ATAAGACACAAAATAATGG
GATAAGAGATAGCCGGTGG -> ATAAGAGATAGCCGGTGGT
GATACCCAAGCTGGCTCGT -> ATACCCAAGCTGGCTCGTG
GATAGACCATGGCCAGACT -> ATAGACCATGGCCAGACTG
GATAGCAGGTCGATGAGTG -> ATAGCAGGTCGATGAGTGG
GATAGCCGGTGGTTGCACA -> ATAGCCGGTGGTTGCACAG
GATAGTTCTAAACTTTCCA -> ATAGTTCTAAACTTTCCAC
GATATACTTGCACGGCGTT -> ATATACTTGCACGGCGTTG
GATATTACTCCCTACATCT -> ATATTACTCCCTACATCTT
GATATTGTTCCTCGTCGGA -> ATATTGTTCCTCGTCGGAC
GATCAATATCTCAGAGAGG -> ATCAATATCTCAGAGAGGT
GATCCAATTTTCTCGGTTG -> ATCCAATTTTCTCGGTTGT
GATCCACCGTATAAGTATG -> ATCCACCGTATAAGTATGT
GATCCACCTCCGTGTTTGT -> ATCCACCTCCGTGTTTGTA
GATCCAGACTATGGTGTTG -> ATCCAGACTATGGTGTTGT
GATCCATCATATAAAGGCG -> ATCCATCATATAAAGGCGG
GATCCATTGATGGTCCCTG -> ATCCATTGATGGTCCCTGT
GATCGAATAGAAACGTTAT -> ATCGAATAGAAACGTTATC
GATCGAGTGCGAGCTGGTA -> ATCGAGTGCGAGCTGGTAT
GATCGATCTCCTCGGGTAT -> ATCGATCTCCTCGGGTATT
GATCGTCTTAGTTCCGTCC -> ATCGTCTTAGTTCCGTCCG
GATCTCCAAACCCGCAATT -> ATCTCCAAACCCGCAATTA
GATCTCCGCAAAACTTCAG -> ATCTCCGCAAAACTTCAGC
GATCTCCTCGGGTATTATC -> ATCTCCTCGGGTATTATCA
GATCTTGGCTGAATACGAG -> ATCTTGGCTGAATACGAGA
GATGAATGGCTCAAATCGA -> ATGAATGGCTCAAATCGAT
GATGAGTACCAGTAGCATA -> ATGAGTACCAGTAGCATAT
GATGAGTGGCATCACGTAG -> ATGAGTGGCATCACGTAGT
GATGATATTGTTCCTCGTC -> ATGATATTGTTCCTCGTCG
GATGCCCTTCAGCTCAGAC -> ATGCCCTTCAGCTCAGACA
GATGGGCTGCTAAGTCGAT -> ATGGGCTGCTAAGTCGATC
GATGGTCCCTGTGTGCCTC -> ATGGTCCCTGTGTGCCTCG
GATGTGAGTTCTTACATAA -> ATGTGAGTTCTTACATAAT
GATTAGTTACACAACCAGC -> ATTAGTTACACAACCAGCC
GATTCAATCTTAGGTGCAG -> ATTCAATCTTAGGTGCAGC
GATTGATTTTGCGGTGAAC -> ATTGATTTTGCGGTGAACG
GATTTCATGCTCGGACTCA -> ATTTCATGCTCGGACTCAC
GATTTGCAAACGAGGGAAT -> ATTTGCAAACGAGGGAATG
GATTTTGCGGTGAACGCGC -> ATTTTGCGGTGAACGCGCC
GCAAAAACCTCGTTCAATC -> CAAAAACCTCGTTCAATCA
GCAAAACTTCAGCCAGAGC -> CAAAACTTCAGCCAGAGCT
GCAAACGAGGGAATGCTGC -> CAAACGAGGGAATGCTGCT
GCAAAGGGCACACCTAACC -> CAAAGGGCACACCTAACCT
GCAAATTTTGCCTCGCGTA -> CAAATTTTGCCTCGCGTAT
GCAAGGACTTCCCGCGGAG -> CAAGGACTTCCCGCGGAGT
GCAATTATAGCGGGCGTCC -> CAATTATAGCGGGCGTCCG
GCACACCTAACCTTTCGAT -> CACACCTAACCTTTCGATG
GCACAGACCGATACCCAAG -> CACAGACCGATACCCAAGC
GCACAGACCGGATCCACCT -> CACAGACCGGATCCACCTC
GCACAGACGCAGGTCTTAA -> CACAGACGCAGGTCTTAAA
GCACAGACTCTCATTCTCA -> CACAGACTCTCATTCTCAT
GCACAGGGCCCGCTAAAAT -> CACAGGGCCCGCTAAAATG
GCACCATGCACCGACGTGT -> CACCATGCACCGACGTGTG
GCACCCATGTATTCATTCG -> CACCCATGTATTCATTCGC
GCACCGACGTGTGAATACC -> CACCGACGTGTGAATACCG
GCACGAGCCCAAGGAGCCT -> CACGAGCCCAAGGAGCCTG
GCACGGCGTTGAACTTCCG -> CACGGCGTTGAACTTCCGC
GCACTACTTTCGATCCATC -> CACTACTTTCGATCCATCA
GCAGACTGTCTTGTACGAT -> CAGACTGTCTTGTACGATA
GCAGCAAGGACTTCCCGCG -> CAGCAAGGACTTCCCGCGG
GCAGCATTACTAGAAGCTA -> CAGCATTACTAGAAGCTAC
GCAGCGACTCGCAGTACTC -> CAGCGACTCGCAGTACTCC
GCAGCGGTGGAACATGTCT -> CAGCGGTGGAACATGTCTG
GCAGGTCGATGAGTGGCAT -> CAGGTCGATGAGTGGCATC
GCAGGTCTTAAAACGGTGT -> CAGGTCTTAAAACGGTGTG
GCAGGTCTTCTTCGACAAC -> CAGGTCTTCTTCGACAACA
GCAGTACTCCGCATACCTC -> CAGTACTCCGCATACCTCA
GCAGTAGTTTGTTGCAGTG -> CAGTAGTTTGTTGCAGTGT
GCAGTGTAATCAGATATAC -> CAGTGTAATCAGATATACT
GCAGTTTGGGGTGGGCATT -> CAGTTTGGGGTGGGCATTA
GCATACCTCATGTGGACGA -> CATACCTCATGTGGACGAT
GCATATTCCGCCTTCTGCG -> CATATTCCGCCTTCTGCGT
GCATCACGTAGTTCCGTCC -> CATCACGTAGTTCCGTCCG
GCATCCCAATAAAGACCAA -> CATCCCAATAAAGACCAAA
GCATGCAAATTTTGCCTCG -> CATGCAAATTTTGCCTCGC
GCATTACAGGTTGGCTTGA -> CATTACAGGTTGGCTTGAC
GCATTACTAGAAGCTACCT -> CATTACTAGAAGCTACCTT
GCATTGTCTTCTCGAAGGG -> CATTGTCTTCTCGAAGGGT
GCATTGTGGACGGCGAGTG -> CATTGTGGACGGCGAGTGT
GCCAAGGAGAATACATAGT -> CCAAGGAGAATACATAGTT
GCCACAACTTTGGGGATTT -> CCACAACTTTGGGGATTTG
GCCACCCAAAACGTGGGGT -> CCACCCAAAACGTGGGGTC
GCCACGGGACAAACACCAA -> CCACGGGACAAACACCAAT
GCCAGACTGCTTCTAGCCT -> CCAGACTGCTTCTAGCCTC
GCCAGAGCTGGGCGGGAGC -> CCAGAGCTGGGCGGGAGCT
GCCATAATCGATGTGAGTT -> CCATAATCGATGTGAGTTC
GCCATAGCGTCGATCTCCG -> CCATAGCGTCGATCTCCGC
GCCCAAGGAGCCTGTCTCG -> CCCAAGGAGCCTGTCTCGT
GCCCATTTCTTAGGAGAGA -> CCCATTTCTTAGGAGAGAG
GCCCCGAACTTTTGTGTTA -> CCCCGAACTTTTGTGTTAG
GCCCGCTAAAATGCCAAGG -> CCCGCTAAAATGCCAAGGA
GCCCTGTAATAGTGACGAA -> CCCTGTAATAGTGACGAAT
GCCCTTCAGCTCAGACAGT -> CCCTTCAGCTCAGACAGTC
GCCGAGGTAATGTCTGTCC -> CCGAGGTAATGTCTGTCCA
GCCGCCCTGTAATAGTGAC -> CCGCCCTGTAATAGTGACG
GCCGCGTGAGAGCAGCGGT -> CCGCGTGAGAGCAGCGGTG
GCCGGAATAACTTTACTGC -> CCGGAATAACTTTACTGCT
GCCGGGCTCAGCATCCCAA -> CCGGGCTCAGCATCCCAAT
GCCGGTGGTTGCACAGGGC -> CCGGTGGTTGCACAGGGCC
GCCTAAACCGTCGGGAAAT -> CCTAAACCGTCGGGAAATC
GCCTACTCCAAGGACCATG -> CCTACTCCAAGGACCATGC
GCCTAGCCATAATCGATGT -> CCTAGCCATAATCGATGTG
GCCTCACCACATTCTTAAC -> CCTCACCACATTCTTAACT
GCCTCGCGTATAGGTGGGT -> CCTCGCGTATAGGTGGGTA
GCCTCGGCACAGACCGATA -> CCTCGGCACAGACCGATAC
GCCTCGGCACAGACCGGAT -> CCTCGGCACAGACCGGATC
GCCTCGGCACAGACGCAGG -> CCTCGGCACAGACGCAGGT
GCCTCGGCACAGACTCTCA -> CCTCGGCACAGACTCTCAT
GCCTCGGTCTGCGTTTTGC -> CCTCGGTCTGCGTTTTGCA
GCCTGACCTCTACGAAGTG -> CCTGACCTCTACGAAGTGG
GCCTGTCTCGTAAGTACAG -> CCTGTCTCGTAAGTACAGT
GCCTGTTCCACGAGAGAAA -> CCTGTTCCACGAGAGAAAT
GCCTTCTGCGTGATCAATA -> CCTTCTGCGTGATCAATAT
GCGACCTGTGTAACCGTGC -> CGACCTGTGTAACCGTGCA
GCGACTCGCAGTACTCCGC -> CGACTCGCAGTACTCCGCA
GCGAGAGGTCACAGTGATT -> CGAGAGGTCACAGTGATTA
GCGAGCTGGTATAATTGAT -> CGAGCTGGTATAATTGATC
GCGAGCTTTCTACGCTGAT -> CGAGCTTTCTACGCTGATG
GCGAGTAATCCCCTAGGCA -> CGAGTAATCCCCTAGGCAG
GCGAGTGTACTACGGGAAG -> CGAGTGTACTACGGGAAGT
GCGATAGACCATGGCCAGA -> CGATAGACCATGGCCAGAC
GCGATCGTCTTAGTTCCGT -> CGATCGTCTTAGTTCCGTC
GCGATTTCATGCTCGGACT -> CGATTTCATGCTCGGACTC
GCGCATGCAAATTTTGCCT -> CGCATGCAAATTTTGCCTC
GCGCCCATTTCTTAGGAGA -> CGCCCATTTCTTAGGAGAG
GCGCCTAAACCGTCGGGAA -> CGCCTAAACCGTCGGGAAA
GCGGACATAGCCACCCAAA -> CGGACATAGCCACCCAAAA
GCGGAGTGGGCGTCTTGAC -> CGGAGTGGGCGTCTTGACG
GCGGCGGTACGAGGGTCCT -> CGGCGGTACGAGGGTCCTG
GCGGCTAGTGGCGGACATA -> CGGCTAGTGGCGGACATAG
GCGGGAGCTTATCATGAGC -> CGGGAGCTTATCATGAGCG
GCGGGCGTCCGGGAAGACA -> CGGGCGTCCGGGAAGACAG
GCGGTACGAGGGTCCTGTG -> CGGTACGAGGGTCCTGTGT
GCGGTGAACGCGCCCATTT -> CGGTGAACGCGCCCATTTC
GCGGTGGAACATGTCTGGA -> CGGTGGAACATGTCTGGAT
GCGTATAGGTGGGTAAGCA -> CGTATAGGTGGGTAAGCAG
GCGTCCACCCCTAGAAAGT -> CGTCCACCCCTAGAAAGTT
GCGTCCGGGAAGACAGCCG -> CGTCCGGGAAGACAGCCGG
GCGTCGATCTCCGCAAAAC -> CGTCGATCTCCGCAAAACT
GCGTCTTGACGGCCGCGTG -> CGTCTTGACGGCCGCGTGA
GCGTGAGAGCAGCGGTGGA -> CGTGAGAGCAGCGGTGGAA
GCGTGATCAATATCTCAGA -> CGTGATCAATATCTCAGAG
GCGTTGAACTTCCGCAATG -> CGTTGAACTTCCGCAATGG
GCGTTTTGCAAAGGGCACA -> CGTTTTGCAAAGGGCACAC
GCTAAAAAGCAGTTTGGGG -> CTAAAAAGCAGTTTGGGGT
GCTAAAATGCCAAGGAGAA -> CTAAAATGCCAAGGAGAAT
GCTAAGTCGATCGAGTGCG -> CTAAGTCGATCGAGTGCGA
GCTACCTTATGATCTCCAA -> CTACCTTATGATCTCCAAA
GCTAGTGGCGGACATAGCC -> CTAGTGGCGGACATAGCCA
GCTCAAATCGATAAGAGAT -> CTCAAATCGATAAGAGATA
GCTCAGACAGTCGCAGCAT -> CTCAGACAGTCGCAGCATT
GCTCAGCATCCCAATAAAG -> CTCAGCATCCCAATAAAGA
GCTCCCAGCAGCAAGGACT -> CTCCCAGCAGCAAGGACTT
GCTCGGACTCACAGCCATA -> CTCGGACTCACAGCCATAG
GCTCGTGTTTTAAAGCCAC -> CTCGTGTTTTAAAGCCACA
GCTGAATACGAGATATTAC -> CTGAATACGAGATATTACT
GCTGATGAATGGCTCAAAT -> CTGATGAATGGCTCAAATC
GCTGCTAAGTCGATCGAGT -> CTGCTAAGTCGATCGAGTG
GCTGCTCCCAGCAGCAAGG -> CTGCTCCCAGCAGCAAGGA
GCTGGCTCGTGTTTTAAAG -> CTGGCTCGTGTTTTAAAGC
GCTGGGCGGGAGCTTATCA -> CTGGGCGGGAGCTTATCAT
GCTGGTATAATTGATCTTG -> CTGGTATAATTGATCTTGG
GCTGTACTCCATTGAGCAA -> CTGTACTCCATTGAGCAAA
GCTTATCATGAGCGGCGGT -> CTTATCATGAGCGGCGGTA
GCTTCTAGCCTCGGTCTGC -> CTTCTAGCCTCGGTCTGCG
GCTTGACCGAGATGAGTAC -> CTTGACCGAGATGAGTACC
GCTTTACGGCCTGACCTCT -> CTTTACGGCCTGACCTCTA
GCTTTCTACGCTGATGAAT -> CTTTCTACGCTGATGAATG
GGAAATCACCAAAGCCGGG -> GAAATCACCAAAGCCGGGC
GGAACAGGTTCGCGATAGA -> GAACAGGTTCGCGATAGAC
GGAACATGTCTGGATAAGA -> GAACATGTCTGGATAAGAC
GGAAGACAGCCGGAATAAC -> GAAGACAGCCGGAATAACT
GGAAGGGGTGGGCTGTACT -> GAAGGGGTGGGCTGTACTC
GGAAGTACGTAGTGTACTA -> GAAGTACGTAGTGTACTAG
GGAATAACTTTACTGCTAA -> GAATAACTTTACTGCTAAA
GGAATGCTGCTCCCAGCAG -> GAATGCTGCTCCCAGCAGC
GGAATTACTTCAACCGTAG -> GAATTACTTCAACCGTAGC
GGACAAACACCAATGTTCT -> GACAAACACCAATGTTCTC
GGACATAGCCACCCAAAAC -> GACATAGCCACCCAAAACG
GGACCATGCCACGGGACAA -> GACCATGCCACGGGACAAA
GGACCCCGACGGGATAGTT -> GACCCCGACGGGATAGTTC
GGACGATCGATCTCCTCGG -> GACGATCGATCTCCTCGGG
GGACGATTGATTTTGCGGT -> GACGATTGATTTTGCGGTG
GGACGGCGAGTGTACTACG -> GACGGCGAGTGTACTACGG
GGACTCACAGCCATAGCGT -> GACTCACAGCCATAGCGTC
GGACTTCCCGCGGAGTGGG -> GACTTCCCGCGGAGTGGGC
GGAGAAAGTGCCTGTTCCA -> GAGAAAGTGCCTGTTCCAC
GGAGAATACATAGTTCCGT -> GAGAATACATAGTTCCGTC
GGAGAGAGGGTTTTGAGTA -> GAGAGAGGGTTTTGAGTAC
GGAGCACCCATGTATTCAT -> GAGCACCCATGTATTCATT
GGAGCCTGTCTCGTAAGTA -> GAGCCTGTCTCGTAAGTAC
GGAGCTTATCATGAGCGGC -> GAGCTTATCATGAGCGGCG
GGAGTGGGCGTCTTGACGG -> GAGTGGGCGTCTTGACGGC
GGATAAGACACAAAATAAT -> GATAAGACACAAAATAATG
GGATAGTTCTAAACTTTCC -> GATAGTTCTAAACTTTCCA
GGATCCAATTTTCTCGGTT -> GATCCAATTTTCTCGGTTG
GGATCCACCGTATAAGTAT -> GATCCACCGTATAAGTATG
GGATCCACCTCCGTGTTTG -> GATCCACCTCCGTGTTTGT
GGATCCAGACTATGGTGTT -> GATCCAGACTATGGTGTTG
GGATCCATTGATGGTCCCT -> GATCCATTGATGGTCCCTG
GGATGATATTGTTCCTCGT -> GATGATATTGTTCCTCGTC
GGATGCCCTTCAGCTCAGA -> GATGCCCTTCAGCTCAGAC
GGATTTGCAAACGAGGGAA -> GATTTGCAAACGAGGGAAT
GGCACACCTAACCTTTCGA -> GCACACCTAACCTTTCGAT
GGCACAGACCGATACCCAA -> GCACAGACCGATACCCAAG
GGCACAGACCGGATCCACC -> GCACAGACCGGATCCACCT
GGCACAGACGCAGGTCTTA -> GCACAGACGCAGGTCTTAA
GGCACAGACTCTCATTCTC -> GCACAGACTCTCATTCTCA
GGCACCATGCACCGACGTG -> GCACCATGCACCGACGTGT
GGCACGAGCCCAAGGAGCC -> GCACGAGCCCAAGGAGCCT
GGCAGACTGTCTTGTACGA -> GCAGACTGTCTTGTACGAT
GGCAGTAGTTTGTTGCAGT -> GCAGTAGTTTGTTGCAGTG
GGCATCACGTAGTTCCGTC -> GCATCACGTAGTTCCGTCC
GGCATTACAGGTTGGCTTG -> GCATTACAGGTTGGCTTGA
GGCCAGACTGCTTCTAGCC -> GCCAGACTGCTTCTAGCCT
GGCCCCGAACTTTTGTGTT -> GCCCCGAACTTTTGTGTTA
GGCCCGCTAAAATGCCAAG -> GCCCGCTAAAATGCCAAGG
GGCCGAGGTAATGTCTGTC -> GCCGAGGTAATGTCTGTCC
GGCCGCGTGAGAGCAGCGG -> GCCGCGTGAGAGCAGCGGT
GGCCTGACCTCTACGAAGT -> GCCTGACCTCTACGAAGTG
GGCGAGTGTACTACGGGAA -> GCGAGTGTACTACGGGAAG
GGCGGACATAGCCACCCAA -> GCGGACATAGCCACCCAAA
GGCGGCTAGTGGCGGACAT -> GCGGCTAGTGGCGGACATA
GGCGGGAGCTTATCATGAG -> GCGGGAGCTTATCATGAGC
GGCGGTACGAGGGTCCTGT -> GCGGTACGAGGGTCCTGTG
GGCGTCCGGGAAGACAGCC -> GCGTCCGGGAAGACAGCCG
GGCGTCTTGACGGCCGCGT -> GCGTCTTGACGGCCGCGTG
GGCGTTGAACTTCCGCAAT -> GCGTTGAACTTCCGCAATG
GGCTAGTGGCGGACATAGC -> GCTAGTGGCGGACATAGCC
GGCTCAAATCGATAAGAGA -> GCTCAAATCGATAAGAGAT
GGCTCAGCATCCCAATAAA -> GCTCAGCATCCCAATAAAG
GGCTCGTGTTTTAAAGCCA -> GCTCGTGTTTTAAAGCCAC
GGCTGAATACGAGATATTA -> GCTGAATACGAGATATTAC
GGCTGCTAAGTCGATCGAG -> GCTGCTAAGTCGATCGAGT
GGCTGTACTCCATTGAGCA -> GCTGTACTCCATTGAGCAA
GGCTTGACCGAGATGAGTA -> GCTTGACCGAGATGAGTAC
GGGAAATCACCAAAGCCGG -> GGAAATCACCAAAGCCGGG
GGGAAGACAGCCGGAATAA -> GGAAGACAGCCGGAATAAC
GGGAAGTACGTAGTGTACT -> GGAAGTACGTAGTGTACTA
GGGAATGCTGCTCCCAGCA -> GGAATGCTGCTCCCAGCAG
GGGACAAACACCAATGTTC -> GGACAAACACCAATGTTCT
GGGAGCTTATCATGAGCGG -> GGAGCTTATCATGAGCGGC
GGGATAGTTCTAAACTTTC -> GGATAGTTCTAAACTTTCC
GGGATTTGCAAACGAGGGA -> GGATTTGCAAACGAGGGAA
GGGCACACCTAACCTTTCG -> GGCACACCTAACCTTTCGA
GGGCATTACAGGTTGGCTT -> GGCATTACAGGTTGGCTTG
GGGCCCCGAACTTTTGTGT -> GGCCCCGAACTTTTGTGTT
GGGCCCGCTAAAATGCCAA -> GGCCCGCTAAAATGCCAAG
GGGCGGGAGCTTATCATGA -> GGCGGGAGCTTATCATGAG
GGGCGTCCGGGAAGACAGC -> GGCGTCCGGGAAGACAGCC
GGGCGTCTTGACGGCCGCG -> GGCGTCTTGACGGCCGCGT
GGGCTCAGCATCCCAATAA -> GGCTCAGCATCCCAATAAA
GGGCTGCTAAGTCGATCGA -> GGCTGCTAAGTCGATCGAG
GGGCTGTACTCCATTGAGC -> GGCTGTACTCCATTGAGCA
GGGGATTTGCAAACGAGGG -> GGGATTTGCAAACGAGGGA
GGGGCCCCGAACTTTTGTG -> GGGCCCCGAACTTTTGTGT
GGGGTCGCCGCCCTGTAAT -> GGGTCGCCGCCCTGTAATA
GGGGTGGGCATTACAGGTT -> GGGTGGGCATTACAGGTTG
GGGGTGGGCTGTACTCCAT -> GGGTGGGCTGTACTCCATT
GGGTAAGCAGGTCTTCTTC -> GGTAAGCAGGTCTTCTTCG
GGGTACGTCCCCACGTGAC -> GGTACGTCCCCACGTGACA
GGGTATTATCACTGTAGTA -> GGTATTATCACTGTAGTAA
GGGTCCTGTGTAGTGCGAC -> GGTCCTGTGTAGTGCGACC
GGGTCGCCGCCCTGTAATA -> GGTCGCCGCCCTGTAATAG
GGGTGGGCATTACAGGTTG -> GGTGGGCATTACAGGTTGG
GGGTGGGCTGTACTCCATT -> GGTGGGCTGTACTCCATTG
GGGTTATGGAGAAAGTGCC -> GGTTATGGAGAAAGTGCCT
GGGTTTTGAGTACACTGGT -> GGTTTTGAGTACACTGGTT
GGTAAGCAGGTCTTCTTCG -> GTAAGCAGGTCTTCTTCGA
GGTAATGTCTGTCCATCTA -> GTAATGTCTGTCCATCTAG
GGTACGAGGGTCCTGTGTA -> GTACGAGGGTCCTGTGTAG
GGTACGTCCCCACGTGACA -> GTACGTCCCCACGTGACAT
GGTATAATTGATCTTGGCT -> GTATAATTGATCTTGGCTG
GGTATTATCACTGTAGTAA -> GTATTATCACTGTAGTAAG
GGTCACAGTGATTAGTTAC -> GTCACAGTGATTAGTTACA
GGTCCCTGTGTGCCTCGGC -> GTCCCTGTGTGCCTCGGCA
GGTCCGTCATATTAAGAGA -> GTCCGTCATATTAAGAGAG
GGTCCTGTGTAGTGCGACC -> GTCCTGTGTAGTGCGACCT
GGTCGATGAGTGGCATCAC -> GTCGATGAGTGGCATCACG
GGTCGCCGCCCTGTAATAG -> GTCGCCGCCCTGTAATAGT
GGTCTGCGTTTTGCAAAGG -> GTCTGCGTTTTGCAAAGGG
GGTCTTAAAACGGTGTGTG -> GTCTTAAAACGGTGTGTGA
GGTCTTCTTCGACAACAAT -> GTCTTCTTCGACAACAATG
GGTGAACGCGCCCATTTCT -> GTGAACGCGCCCATTTCTT
GGTGCAGCGACTCGCAGTA -> GTGCAGCGACTCGCAGTAC
GGTGGAACAGGTTCGCGAT -> GTGGAACAGGTTCGCGATA
GGTGGAACATGTCTGGATA -> GTGGAACATGTCTGGATAA
GGTGGGCATTACAGGTTGG -> GTGGGCATTACAGGTTGGC
GGTGGGCTGTACTCCATTG -> GTGGGCTGTACTCCATTGA
GGTGGGGCCCCGAACTTTT -> GTGGGGCCCCGAACTTTTG
GGTGGGTAAGCAGGTCTTC -> GTGGGTAAGCAGGTCTTCT
GGTGGTGGGGCCCCGAACT -> GTGGTGGGGCCCCGAACTT
GGTGGTTGCACAGGGCCCG -> GTGGTTGCACAGGGCCCGC
GGTGTGTGAAAAGTCCCAT -> GTGTGTGAAAAGTCCCATA
GGTGTTGTGTGCCTCGGCA -> GTGTTGTGTGCCTCGGCAC
GGTTACATATCACCCATCA -> GTTACATATCACCCATCAA
GGTTATGGAGAAAGTGCCT -> GTTATGGAGAAAGTGCCTG
GGTTCGCGATAGACCATGG -> GTTCGCGATAGACCATGGC
GGTTCTCTCTGAATACGTG -> GTTCTCTCTGAATACGTGG
GGTTGCACAGGGCCCGCTA -> GTTGCACAGGGCCCGCTAA
GGTTGGCTTGACCGAGATG -> GTTGGCTTGACCGAGATGA
GGTTGTGTGCCTCGGCACA -> GTTGTGTGCCTCGGCACAG
GGTTTTGAGTACACTGGTT -> GTTTTGAGTACACTGGTTA
GTAAATTCCCGGAGCACCC -> TAAATTCCCGGAGCACCCA
GTAACCGTGCACTACTTTC -> TAACCGTGCACTACTTTCG
GTAAGCAGGTCTTCTTCGA -> TAAGCAGGTCTTCTTCGAC
GTAAGTACAGTTGATTCAA -> TAAGTACAGTTGATTCAAT
GTAAGTGCGAGAGGTCACA -> TAAGTGCGAGAGGTCACAG
GTAATAGTGACGAATATCA -> TAATAGTGACGAATATCAA
GTAATCAGATATACTTGCA -> TAATCAGATATACTTGCAC
GTAATCCCCTAGGCAGTAG -> TAATCCCCTAGGCAGTAGT
GTAATGTCTGTCCATCTAG -> TAATGTCTGTCCATCTAGC
GTACACTGGTTACATATCA -> TACACTGGTTACATATCAC
GTACAGTTGATTCAATCTT -> TACAGTTGATTCAATCTTA
GTACCAGTAGCATATTCCG -> TACCAGTAGCATATTCCGC
GTACGAGGGTCCTGTGTAG -> TACGAGGGTCCTGTGTAGT
GTACGATAGCAGGTCGATG -> TACGATAGCAGGTCGATGA
GTACGTAGTGTACTAGTTC -> TACGTAGTGTACTAGTTCC
GTACGTCCCCACGTGACAT -> TACGTCCCCACGTGACATT
GTACTACGGGAAGTACGTA -> TACTACGGGAAGTACGTAG
GTACTAGTTCCGTCCGGAT -> TACTAGTTCCGTCCGGATC
GTACTCCATTGAGCAAAAA -> TACTCCATTGAGCAAAAAC
GTACTCCGCATACCTCATG -> TACTCCGCATACCTCATGT
GTAGAGGATGATATTGTTC -> TAGAGGATGATATTGTTCC
GTAGCATATTCCGCCTTCT -> TAGCATATTCCGCCTTCTG
GTAGCGCATGCAAATTTTG -> TAGCGCATGCAAATTTTGC
GTAGTAAGTGCGAGAGGTC -> TAGTAAGTGCGAGAGGTCA
GTAGTGCGACCTGTGTAAC -> TAGTGCGACCTGTGTAACC
GTAGTGTACTAGTTCCGTC -> TAGTGTACTAGTTCCGTCC
GTAGTTCCGTCCGGATCCA -> TAGTTCCGTCCGGATCCAG
GTAGTTTGTTGCAGTGTAA -> TAGTTTGTTGCAGTGTAAT
GTATAAGTATGTGTGCCTC -> TATAAGTATGTGTGCCTCG
GTATAATTGATCTTGGCTG -> TATAATTGATCTTGGCTGA
GTATAGGTGGGTAAGCAGG -> TATAGGTGGGTAAGCAGGT
GTATGTGTGCCTCGGCACA -> TATGTGTGCCTCGGCACAG
GTATTATCACTGTAGTAAG -> TATTATCACTGTAGTAAGT
GTATTCATTCGCGCCTAAA -> TATTCATTCGCGCCTAAAC
GTCACAGTGATTAGTTACA -> TCACAGTGATTAGTTACAC
GTCATATTAAGAGAGCGTC -> TCATATTAAGAGAGCGTCC
GTCCACCCCTAGAAAGTTA -> TCCACCCCTAGAAAGTTAT
GTCCATCTAGCATTGTGGA -> TCCATCTAGCATTGTGGAC
GTCCCATACTGGTGGAACA -> TCCCATACTGGTGGAACAG
GTCCCCACGTGACATTGAC -> TCCCCACGTGACATTGACC
GTCCCTGTGTGCCTCGGCA -> TCCCTGTGTGCCTCGGCAC
GTCCGGATCCAATTTTCTC -> TCCGGATCCAATTTTCTCG
GTCCGGATCCACCGTATAA -> TCCGGATCCACCGTATAAG
GTCCGGATCCAGACTATGG -> TCCGGATCCAGACTATGGT
GTCCGGATCCATTGATGGT -> TCCGGATCCATTGATGGTC
GTCCGGGAAGACAGCCGGA -> TCCGGGAAGACAGCCGGAA
GTCCGTCATATTAAGAGAG -> TCCGTCATATTAAGAGAGC
GTCCTGTGTAGTGCGACCT -> TCCTGTGTAGTGCGACCTG
GTCGATCGAGTGCGAGCTG -> TCGATCGAGTGCGAGCTGG
GTCGATCTCCGCAAAACTT -> TCGATCTCCGCAAAACTTC
GTCGATGAGTGGCATCACG -> TCGATGAGTGGCATCACGT
GTCGCAGCATTACTAGAAG -> TCGCAGCATTACTAGAAGC
GTCGCCGCCCTGTAATAGT -> TCGCCGCCCTGTAATAGTG
GTCGGACCCCGACGGGATA -> TCGGACCCCGACGGGATAG
GTCGGGAAATCACCAAAGC -> TCGGGAAATCACCAAAGCC
GTCTCGTAAGTACAGTTGA -> TCTCGTAAGTACAGTTGAT
GTCTGCGTTTTGCAAAGGG -> TCTGCGTTTTGCAAAGGGC
GTCTGGATAAGACACAAAA -> TCTGGATAAGACACAAAAT
GTCTGTCCATCTAGCATTG -> TCTGTCCATCTAGCATTGT
GTCTTAAAACGGTGTGTGA -> TCTTAAAACGGTGTGTGAA
GTCTTAGTTCCGTCCGGAT -> TCTTAGTTCCGTCCGGATC
GTCTTCTCGAAGGGTTATG -> TCTTCTCGAAGGGTTATGG
GTCTTCTTCGACAACAATG -> TCTTCTTCGACAACAATGC
GTCTTGACGGCCGCGTGAG -> TCTTGACGGCCGCGTGAGA
GTCTTGTACGATAGCAGGT -> TCTTGTACGATAGCAGGTC
GTGAAAAGTCCCATACTGG -> TGAAAAGTCCCATACTGGT
GTGAAACCCCACGGAAGGG -> TGAAACCCCACGGAAGGGG
GTGAACGCGCCCATTTCTT -> TGAACGCGCCCATTTCTTA
GTGAATACCGGAATTACTT -> TGAATACCGGAATTACTTC
GTGACATTGACCCCACGCG -> TGACATTGACCCCACGCGA
GTGACGAATATCAACACAG -> TGACGAATATCAACACAGA
GTGAGAGCAGCGGTGGAAC -> TGAGAGCAGCGGTGGAACA
GTGAGTTCTTACATAATAT -> TGAGTTCTTACATAATATG
GTGATCAATATCTCAGAGA -> TGATCAATATCTCAGAGAG
GTGATTAGTTACACAACCA -> TGATTAGTTACACAACCAG
GTGCACTACTTTCGATCCA -> TGCACTACTTTCGATCCAT
GTGCAGCGACTCGCAGTAC -> TGCAGCGACTCGCAGTACT
GTGCCTCGGCACAGACCGA -> TGCCTCGGCACAGACCGAT
GTGCCTCGGCACAGACCGG -> TGCCTCGGCACAGACCGGA
GTGCCTCGGCACAGACGCA -> TGCCTCGGCACAGACGCAG
GTGCCTCGGCACAGACTCT -> TGCCTCGGCACAGACTCTC
GTGCCTGTTCCACGAGAGA -> TGCCTGTTCCACGAGAGAA
GTGCGACCTGTGTAACCGT -> TGCGACCTGTGTAACCGTG
GTGCGAGAGGTCACAGTGA -> TGCGAGAGGTCACAGTGAT
GTGCGAGCTGGTATAATTG -> TGCGAGCTGGTATAATTGA
GTGGAACAGGTTCGCGATA -> TGGAACAGGTTCGCGATAG
GTGGAACATGTCTGGATAA -> TGGAACATGTCTGGATAAG
GTGGACGATCGATCTCCTC -> TGGACGATCGATCTCCTCG
GTGGACGATTGATTTTGCG -> TGGACGATTGATTTTGCGG
GTGGACGGCGAGTGTACTA -> TGGACGGCGAGTGTACTAC
GTGGCACCATGCACCGACG -> TGGCACCATGCACCGACGT
GTGGCATCACGTAGTTCCG -> TGGCATCACGTAGTTCCGT
GTGGCGGACATAGCCACCC -> TGGCGGACATAGCCACCCA
GTGGGCATTACAGGTTGGC -> TGGGCATTACAGGTTGGCT
GTGGGCGTCTTGACGGCCG -> TGGGCGTCTTGACGGCCGC
GTGGGCTGTACTCCATTGA -> TGGGCTGTACTCCATTGAG
GTGGGGCCCCGAACTTTTG -> TGGGGCCCCGAACTTTTGT
GTGGGGTCGCCGCCCTGTA -> TGGGGTCGCCGCCCTGTAA
GTGGGTAAGCAGGTCTTCT -> TGGGTAAGCAGGTCTTCTT
GTGGTGGGGCCCCGAACTT -> TGGTGGGGCCCCGAACTTT
GTGGTTGCACAGGGCCCGC -> TGGTTGCACAGGGCCCGCT
GTGTAACCGTGCACTACTT -> TGTAACCGTGCACTACTTT
GTGTAATCAGATATACTTG -> TGTAATCAGATATACTTGC
GTGTACTACGGGAAGTACG -> TGTACTACGGGAAGTACGT
GTGTACTAGTTCCGTCCGG -> TGTACTAGTTCCGTCCGGA
GTGTAGTGCGACCTGTGTA -> TGTAGTGCGACCTGTGTAA
GTGTGAAAAGTCCCATACT -> TGTGAAAAGTCCCATACTG
GTGTGAATACCGGAATTAC -> TGTGAATACCGGAATTACT
GTGTGCCTCGGCACAGACC -> TGTGCCTCGGCACAGACCG, TGTGCCTCGGCACAGACCG
GTGTGCCTCGGCACAGACG -> TGTGCCTCGGCACAGACGC
GTGTGCCTCGGCACAGACT -> TGTGCCTCGGCACAGACTC
GTGTGTGAAAAGTCCCATA -> TGTGTGAAAAGTCCCATAC
GTGTTAGCGAGTAATCCCC -> TGTTAGCGAGTAATCCCCT
GTGTTGTGTGCCTCGGCAC -> TGTTGTGTGCCTCGGCACA
GTGTTTGTAAATTCCCGGA -> TGTTTGTAAATTCCCGGAG
GTGTTTTAAAGCCACAACT -> TGTTTTAAAGCCACAACTT
GTTACACAACCAGCCTACT -> TTACACAACCAGCCTACTC
GTTACATATCACCCATCAA -> TTACATATCACCCATCAAT
GTTAGCGAGTAATCCCCTA -> TTAGCGAGTAATCCCCTAG
GTTATCGTGAAACCCCACG -> TTATCGTGAAACCCCACGG
GTTATGGAGAAAGTGCCTG -> TTATGGAGAAAGTGCCTGT
GTTATTAGCCTAGCCATAA -> TTATTAGCCTAGCCATAAT
GTTCAATCATTACTGTAGA -> TTCAATCATTACTGTAGAG
GTTCCACGAGAGAAATACC -> TTCCACGAGAGAAATACCG
GTTCCGTCCGGATCCAATT -> TTCCGTCCGGATCCAATTT
GTTCCGTCCGGATCCACCG -> TTCCGTCCGGATCCACCGT
GTTCCGTCCGGATCCAGAC -> TTCCGTCCGGATCCAGACT
GTTCCGTCCGGATCCATTG -> TTCCGTCCGGATCCATTGA
GTTCCTCGTCGGACCCCGA -> TTCCTCGTCGGACCCCGAC
GTTCGCGATAGACCATGGC -> TTCGCGATAGACCATGGCC
GTTCTAAACTTTCCACCTA -> TTCTAAACTTTCCACCTAG
GTTCTCGAGGATGCCCTTC -> TTCTCGAGGATGCCCTTCA
GTTCTCTCTGAATACGTGG -> TTCTCTCTGAATACGTGGA
GTTCTTACATAATATGAAG -> TTCTTACATAATATGAAGA
GTTGATTCAATCTTAGGTG -> TTGATTCAATCTTAGGTGC
GTTGCACAGGGCCCGCTAA -> TTGCACAGGGCCCGCTAAA
GTTGCAGTGTAATCAGATA -> TTGCAGTGTAATCAGATAT
GTTGGCTTGACCGAGATGA -> TTGGCTTGACCGAGATGAG
GTTGTGTGCCTCGGCACAG -> TTGTGTGCCTCGGCACAGA, TTGTGTGCCTCGGCACAGA
GTTTGGGGTGGGCATTACA -> TTTGGGGTGGGCATTACAG
GTTTGTAAATTCCCGGAGC -> TTTGTAAATTCCCGGAGCA
GTTTGTTGCAGTGTAATCA -> TTTGTTGCAGTGTAATCAG
GTTTTAAAGCCACAACTTT -> TTTTAAAGCCACAACTTTG
GTTTTGAGTACACTGGTTA -> TTTTGAGTACACTGGTTAC
GTTTTGCAAAGGGCACACC -> TTTTGCAAAGGGCACACCT
TAAAAAGCAGTTTGGGGTG -> AAAAAGCAGTTTGGGGTGG
TAAAACGGTGTGTGAAAAG -> AAAACGGTGTGTGAAAAGT
TAAAATGCCAAGGAGAATA -> AAAATGCCAAGGAGAATAC
TAAACCGTCGGGAAATCAC -> AAACCGTCGGGAAATCACC
TAAACTTTCCACCTAGGGT -> AAACTTTCCACCTAGGGTA
TAAAGACCAAAGCCTCACC -> AAAGACCAAAGCCTCACCA
TAAAGCCACAACTTTGGGG -> AAAGCCACAACTTTGGGGA
TAAAGGCGGCTAGTGGCGG -> AAAGGCGGCTAGTGGCGGA
TAAATTCCCGGAGCACCCA -> AAATTCCCGGAGCACCCAT
TAACCGTGCACTACTTTCG -> AACCGTGCACTACTTTCGA
TAACCTTTCGATGGGCTGC -> AACCTTTCGATGGGCTGCT
TAACTTGAAGCGATTTCAT -> AACTTGAAGCGATTTCATG
TAACTTTACTGCTAAAAAG -> AACTTTACTGCTAAAAAGC
TAAGACACAAAATAATGGT -> AAGACACAAAATAATGGTT
TAAGAGAGCGTCCACCCCT -> AAGAGAGCGTCCACCCCTA
TAAGAGATAGCCGGTGGTT -> AAGAGATAGCCGGTGGTTG
TAAGCAGGTCTTCTTCGAC -> AAGCAGGTCTTCTTCGACA
TAAGTACAGTTGATTCAAT -> AAGTACAGTTGATTCAATC
TAAGTATGTGTGCCTCGGC -> AAGTATGTGTGCCTCGGCA
TAAGTCGATCGAGTGCGAG -> AAGTCGATCGAGTGCGAGC
TAAGTGCGAGAGGTCACAG -> AAGTGCGAGAGGTCACAGT
TAATAGTGACGAATATCAA -> AATAGTGACGAATATCAAC
TAATATGAAGATCGAATAG -> AATATGAAGATCGAATAGA
TAATCAGATATACTTGCAC -> AATCAGATATACTTGCACG
TAATCCCCTAGGCAGTAGT -> AATCCCCTAGGCAGTAGTT
TAATCGATGTGAGTTCTTA -> AATCGATGTGAGTTCTTAC
TAATGAGGTCCGTCATATT -> AATGAGGTCCGTCATATTA
TAATGGTTCTCTCTGAATA -> AATGGTTCTCTCTGAATAC
TAATGTCTGTCCATCTAGC -> AATGTCTGTCCATCTAGCA
TAATTGATCTTGGCTGAAT -> AATTGATCTTGGCTGAATA
TACACAACCAGCCTACTCC -> ACACAACCAGCCTACTCCA
TACACTGGTTACATATCAC -> ACACTGGTTACATATCACC
TACAGGTTGGCTTGACCGA -> ACAGGTTGGCTTGACCGAG
TACAGTTGATTCAATCTTA -> ACAGTTGATTCAATCTTAG
TACATAATATGAAGATCGA -> ACATAATATGAAGATCGAA
TACATAGTTCCGTCCGGAT -> ACATAGTTCCGTCCGGATC
TACATATCACCCATCAATT -> ACATATCACCCATCAATTA
TACATCTTGAATTCGCGAG -> ACATCTTGAATTCGCGAGC
TACCAGTAGCATATTCCGC -> ACCAGTAGCATATTCCGCC
TACCCAAGCTGGCTCGTGT -> ACCCAAGCTGGCTCGTGTT
TACCGGAATTACTTCAACC -> ACCGGAATTACTTCAACCG
TACCGGCCGAGGTAATGTC -> ACCGGCCGAGGTAATGTCT
TACCTCATGTGGACGATTG -> ACCTCATGTGGACGATTGA
TACCTTATGATCTCCAAAC -> ACCTTATGATCTCCAAACC
TACGAAGTGGCACCATGCA -> ACGAAGTGGCACCATGCAC
TACGAGATATTACTCCCTA -> ACGAGATATTACTCCCTAC
TACGAGGGTCCTGTGTAGT -> ACGAGGGTCCTGTGTAGTG
TACGATAGCAGGTCGATGA -> ACGATAGCAGGTCGATGAG
TACGCTGATGAATGGCTCA -> ACGCTGATGAATGGCTCAA
TACGGCCTGACCTCTACGA -> ACGGCCTGACCTCTACGAA
TACGGGAAGTACGTAGTGT -> ACGGGAAGTACGTAGTGTA
TACGTAGTGTACTAGTTCC -> ACGTAGTGTACTAGTTCCG
TACGTCCCCACGTGACATT -> ACGTCCCCACGTGACATTG
TACGTGGACGATCGATCTC -> ACGTGGACGATCGATCTCC
TACTACGGGAAGTACGTAG -> ACTACGGGAAGTACGTAGT
TACTAGAAGCTACCTTATG -> ACTAGAAGCTACCTTATGA
TACTAGTTCCGTCCGGATC -> ACTAGTTCCGTCCGGATCC
TACTCCAAGGACCATGCCA -> ACTCCAAGGACCATGCCAC
TACTCCATTGAGCAAAAAC -> ACTCCATTGAGCAAAAACC
TACTCCCTACATCTTGAAT -> ACTCCCTACATCTTGAATT
TACTCCGCATACCTCATGT -> ACTCCGCATACCTCATGTG
TACTGCTAAAAAGCAGTTT -> ACTGCTAAAAAGCAGTTTG
TACTGGTGGAACAGGTTCG -> ACTGGTGGAACAGGTTCGC
TACTGTAGAGGATGATATT -> ACTGTAGAGGATGATATTG
TACTTCAACCGTAGCGCAT -> ACTTCAACCGTAGCGCATG
TACTTGCACGGCGTTGAAC -> ACTTGCACGGCGTTGAACT
TACTTTCGATCCATCATAT -> ACTTTCGATCCATCATATA
TAGAAACGTTATCGTGAAA -> AGAAACGTTATCGTGAAAC
TAGAAAGTTATTAGCCTAG -> AGAAAGTTATTAGCCTAGC
TAGAAGCTACCTTATGATC -> AGAAGCTACCTTATGATCT
TAGACCATGGCCAGACTGC -> AGACCATGGCCAGACTGCT
TAGAGGATGATATTGTTCC -> AGAGGATGATATTGTTCCT
TAGCAGGTCGATGAGTGGC -> AGCAGGTCGATGAGTGGCA
TAGCATATTCCGCCTTCTG -> AGCATATTCCGCCTTCTGC
TAGCATTGTGGACGGCGAG -> AGCATTGTGGACGGCGAGT
TAGCCACCCAAAACGTGGG -> AGCCACCCAAAACGTGGGG
TAGCCATAATCGATGTGAG -> AGCCATAATCGATGTGAGT
TAGCCGGTGGTTGCACAGG -> AGCCGGTGGTTGCACAGGG
TAGCCTAGCCATAATCGAT -> AGCCTAGCCATAATCGATG
TAGCCTCGGTCTGCGTTTT -> AGCCTCGGTCTGCGTTTTG
TAGCGAGTAATCCCCTAGG -> AGCGAGTAATCCCCTAGGC
TAGCGCATGCAAATTTTGC -> AGCGCATGCAAATTTTGCC
TAGCGGGCGTCCGGGAAGA -> AGCGGGCGTCCGGGAAGAC
TAGCGTCGATCTCCGCAAA -> AGCGTCGATCTCCGCAAAA
TAGGAGAGAGGGTTTTGAG -> AGGAGAGAGGGTTTTGAGT
TAGGCAGTAGTTTGTTGCA -> AGGCAGTAGTTTGTTGCAG
TAGGGTACGTCCCCACGTG -> AGGGTACGTCCCCACGTGA
TAGGTGCAGCGACTCGCAG -> AGGTGCAGCGACTCGCAGT
TAGGTGGGTAAGCAGGTCT -> AGGTGGGTAAGCAGGTCTT
TAGTAAGTGCGAGAGGTCA -> AGTAAGTGCGAGAGGTCAC
TAGTGACGAATATCAACAC -> AGTGACGAATATCAACACA
TAGTGCGACCTGTGTAACC -> AGTGCGACCTGTGTAACCG
TAGTGGCGGACATAGCCAC -> AGTGGCGGACATAGCCACC
TAGTGTACTAGTTCCGTCC -> AGTGTACTAGTTCCGTCCG
TAGTTACACAACCAGCCTA -> AGTTACACAACCAGCCTAC
TAGTTCCGTCCGGATCCAA -> AGTTCCGTCCGGATCCAAT
TAGTTCCGTCCGGATCCAC -> AGTTCCGTCCGGATCCACC
TAGTTCCGTCCGGATCCAG -> AGTTCCGTCCGGATCCAGA
TAGTTCCGTCCGGATCCAT -> AGTTCCGTCCGGATCCATT
TAGTTCTAAACTTTCCACC -> AGTTCTAAACTTTCCACCT
TAGTTTGTTGCAGTGTAAT -> AGTTTGTTGCAGTGTAATC
TATAAAGGCGGCTAGTGGC -> ATAAAGGCGGCTAGTGGCG
TATAAGTATGTGTGCCTCG -> ATAAGTATGTGTGCCTCGG
TATAATTGATCTTGGCTGA -> ATAATTGATCTTGGCTGAA
TATACTTGCACGGCGTTGA -> ATACTTGCACGGCGTTGAA
TATAGCGGGCGTCCGGGAA -> ATAGCGGGCGTCCGGGAAG
TATAGGTGGGTAAGCAGGT -> ATAGGTGGGTAAGCAGGTC
TATATTATTATTGGCACGA -> ATATTATTATTGGCACGAG
TATCAACACAGAAGGCAGA -> ATCAACACAGAAGGCAGAC
TATCACCCATCAATTAATG -> ATCACCCATCAATTAATGA
TATCACTGTAGTAAGTGCG -> ATCACTGTAGTAAGTGCGA
TATCATGAGCGGCGGTACG -> ATCATGAGCGGCGGTACGA
TATCGTGAAACCCCACGGA -> ATCGTGAAACCCCACGGAA
TATCTCAGAGAGGTGGTGG -> ATCTCAGAGAGGTGGTGGG
TATGAAGATCGAATAGAAA -> ATGAAGATCGAATAGAAAC
TATGATCTCCAAACCCGCA -> ATGATCTCCAAACCCGCAA
TATGGAGAAAGTGCCTGTT -> ATGGAGAAAGTGCCTGTTC
TATGGTGTTGTGTGCCTCG -> ATGGTGTTGTGTGCCTCGG
TATGTGTGCCTCGGCACAG -> ATGTGTGCCTCGGCACAGA
TATTAAGAGAGCGTCCACC -> ATTAAGAGAGCGTCCACCC
TATTACTCCCTACATCTTG -> ATTACTCCCTACATCTTGA
TATTAGCCTAGCCATAATC -> ATTAGCCTAGCCATAATCG
TATTATCACTGTAGTAAGT -> ATTATCACTGTAGTAAGTG
TATTATTATTGGCACGAGC -> ATTATTATTGGCACGAGCC
TATTATTGGCACGAGCCCA -> ATTATTGGCACGAGCCCAA
TATTCATTCGCGCCTAAAC -> ATTCATTCGCGCCTAAACC
TATTCCGCCTTCTGCGTGA -> ATTCCGCCTTCTGCGTGAT
TATTGGCACGAGCCCAAGG -> ATTGGCACGAGCCCAAGGA
TATTGTTCCTCGTCGGACC -> ATTGTTCCTCGTCGGACCC
TCAAATCGATAAGAGATAG -> CAAATCGATAAGAGATAGC
TCAACACAGAAGGCAGACT -> CAACACAGAAGGCAGACTG
TCAACCGTAGCGCATGCAA -> CAACCGTAGCGCATGCAAA
TCAATATCTCAGAGAGGTG -> CAATATCTCAGAGAGGTGG
TCAATCATTACTGTAGAGG -> CAATCATTACTGTAGAGGA
TCAATCTTAGGTGCAGCGA -> CAATCTTAGGTGCAGCGAC
TCAATTAATGAGGTCCGTC -> CAATTAATGAGGTCCGTCA
TCACAGCCATAGCGTCGAT -> CACAGCCATAGCGTCGATC
TCACAGTGATTAGTTACAC -> CACAGTGATTAGTTACACA
TCACCAAAGCCGGGCTCAG -> CACCAAAGCCGGGCTCAGC
TCACCACATTCTTAACTTG -> CACCACATTCTTAACTTGA
TCACCCATCAATTAATGAG -> CACCCATCAATTAATGAGG
TCACGTAGTTCCGTCCGGA -> CACGTAGTTCCGTCCGGAT
TCACTGTAGTAAGTGCGAG -> CACTGTAGTAAGTGCGAGA
TCAGACAGTCGCAGCATTA -> CAGACAGTCGCAGCATTAC
TCAGAGAGGTGGTGGGGCC -> CAGAGAGGTGGTGGGGCCC
TCAGATATACTTGCACGGC -> CAGATATACTTGCACGGCG
TCAGCATCCCAATAAAGAC -> CAGCATCCCAATAAAGACC
TCAGCCAGAGCTGGGCGGG -> CAGCCAGAGCTGGGCGGGA
TCAGCTCAGACAGTCGCAG -> CAGCTCAGACAGTCGCAGC
TCATATAAAGGCGGCTAGT -> CATATAAAGGCGGCTAGTG
TCATATTAAGAGAGCGTCC -> CATATTAAGAGAGCGTCCA
TCATGAGCGGCGGTACGAG -> CATGAGCGGCGGTACGAGG
TCATGCTCGGACTCACAGC -> CATGCTCGGACTCACAGCC
TCATGTGGACGATTGATTT -> CATGTGGACGATTGATTTT
TCATTACTGTAGAGGATGA -> CATTACTGTAGAGGATGAT
TCATTCGCGCCTAAACCGT -> CATTCGCGCCTAAACCGTC
TCATTCTCATTTGCTTTAC -> CATTCTCATTTGCTTTACG
TCATTTGCTTTACGGCCTG -> CATTTGCTTTACGGCCTGA
TCCAAACCCGCAATTATAG -> CCAAACCCGCAATTATAGC
TCCAAGGACCATGCCACGG -> CCAAGGACCATGCCACGGG
TCCAATTTTCTCGGTTGTG -> CCAATTTTCTCGGTTGTGT
TCCACCCCTAGAAAGTTAT -> CCACCCCTAGAAAGTTATT
TCCACCGTATAAGTATGTG -> CCACCGTATAAGTATGTGT
TCCACCTAGGGTACGTCCC -> CCACCTAGGGTACGTCCCC
TCCACCTCCGTGTTTGTAA -> CCACCTCCGTGTTTGTAAA
TCCACGAGAGAAATACCGG -> CCACGAGAGAAATACCGGC
TCCAGACTATGGTGTTGTG -> CCAGACTATGGTGTTGTGT
TCCATCATATAAAGGCGGC -> CCATCATATAAAGGCGGCT
TCCATCTAGCATTGTGGAC -> CCATCTAGCATTGTGGACG
TCCATTGAGCAAAAACCTC -> CCATTGAGCAAAAACCTCG
TCCATTGATGGTCCCTGTG -> CCATTGATGGTCCCTGTGT
TCCCAATAAAGACCAAAGC -> CCCAATAAAGACCAAAGCC
TCCCAGCAGCAAGGACTTC -> CCCAGCAGCAAGGACTTCC
TCCCATACTGGTGGAACAG -> CCCATACTGGTGGAACAGG
TCCCCACGTGACATTGACC -> CCCCACGTGACATTGACCC
TCCCCTAGGCAGTAGTTTG -> CCCCTAGGCAGTAGTTTGT
TCCCGCGGAGTGGGCGTCT -> CCCGCGGAGTGGGCGTCTT
TCCCGGAGCACCCATGTAT -> CCCGGAGCACCCATGTATT
TCCCTACATCTTGAATTCG -> CCCTACATCTTGAATTCGC
TCCCTGTGTGCCTCGGCAC -> CCCTGTGTGCCTCGGCACA
TCCGCAAAACTTCAGCCAG -> CCGCAAAACTTCAGCCAGA
TCCGCATACCTCATGTGGA -> CCGCATACCTCATGTGGAC
TCCGCCTTCTGCGTGATCA -> CCGCCTTCTGCGTGATCAA
TCCGGATCCAATTTTCTCG -> CCGGATCCAATTTTCTCGG
TCCGGATCCACCGTATAAG -> CCGGATCCACCGTATAAGT
TCCGGATCCAGACTATGGT -> CCGGATCCAGACTATGGTG
TCCGGATCCATTGATGGTC -> CCGGATCCATTGATGGTCC
TCCGGGAAGACAGCCGGAA -> CCGGGAAGACAGCCGGAAT
TCCGTCATATTAAGAGAGC -> CCGTCATATTAAGAGAGCG
TCCGTCCGGATCCAATTTT -> CCGTCCGGATCCAATTTTC
TCCGTCCGGATCCACCGTA -> CCGTCCGGATCCACCGTAT
TCCGTCCGGATCCAGACTA -> CCGTCCGGATCCAGACTAT
TCCGTCCGGATCCATTGAT -> CCGTCCGGATCCATTGATG
TCCGTGTTTGTAAATTCCC -> CCGTGTTTGTAAATTCCCG
TCCTCGGGTATTATCACTG -> CCTCGGGTATTATCACTGT
TCCTCGTCGGACCCCGACG -> CCTCGTCGGACCCCGACGG
TCCTGTGTAGTGCGACCTG -> CCTGTGTAGTGCGACCTGT
TCGAAGGGTTATGGAGAAA -> CGAAGGGTTATGGAGAAAG
TCGAATAGAAACGTTATCG -> CGAATAGAAACGTTATCGT
TCGACAACAATGCATTGTC -> CGACAACAATGCATTGTCT
TCGAGGATGCCCTTCAGCT -> CGAGGATGCCCTTCAGCTC
TCGAGTGCGAGCTGGTATA -> CGAGTGCGAGCTGGTATAA
TCGATAAGAGATAGCCGGT -> CGATAAGAGATAGCCGGTG
TCGATCCATCATATAAAGG -> CGATCCATCATATAAAGGC
TCGATCGAGTGCGAGCTGG -> CGATCGAGTGCGAGCTGGT
TCGATCTCCGCAAAACTTC -> CGATCTCCGCAAAACTTCA
TCGATCTCCTCGGGTATTA -> CGATCTCCTCGGGTATTAT
TCGATGAGTGGCATCACGT -> CGATGAGTGGCATCACGTA
TCGATGGGCTGCTAAGTCG -> CGATGGGCTGCTAAGTCGA
TCGATGTGAGTTCTTACAT -> CGATGTGAGTTCTTACATA
TCGCAGCATTACTAGAAGC -> CGCAGCATTACTAGAAGCT
TCGCAGTACTCCGCATACC -> CGCAGTACTCCGCATACCT
TCGCCGCCCTGTAATAGTG -> CGCCGCCCTGTAATAGTGA
TCGCGAGCTTTCTACGCTG -> CGCGAGCTTTCTACGCTGA
TCGCGATAGACCATGGCCA -> CGCGATAGACCATGGCCAG
TCGCGCCTAAACCGTCGGG -> CGCGCCTAAACCGTCGGGA
TCGCGTATAGGTGGGTAAG -> CGCGTATAGGTGGGTAAGC
TCGGACCCCGACGGGATAG -> CGGACCCCGACGGGATAGT
TCGGACTCACAGCCATAGC -> CGGACTCACAGCCATAGCG
TCGGCACAGACCGATACCC -> CGGCACAGACCGATACCCA
TCGGCACAGACCGGATCCA -> CGGCACAGACCGGATCCAC
TCGGCACAGACGCAGGTCT -> CGGCACAGACGCAGGTCTT
TCGGCACAGACTCTCATTC -> CGGCACAGACTCTCATTCT
TCGGGAAATCACCAAAGCC -> CGGGAAATCACCAAAGCCG
TCGGGTATTATCACTGTAG -> CGGGTATTATCACTGTAGT
TCGGTCTGCGTTTTGCAAA -> CGGTCTGCGTTTTGCAAAG
TCGGTTGTGTGCCTCGGCA -> CGGTTGTGTGCCTCGGCAC
TCGTAAGTACAGTTGATTC -> CGTAAGTACAGTTGATTCA
TCGTCGGACCCCGACGGGA -> CGTCGGACCCCGACGGGAT
TCGTCTTAGTTCCGTCCGG -> CGTCTTAGTTCCGTCCGGA
TCGTGAAACCCCACGGAAG -> CGTGAAACCCCACGGAAGG
TCGTGTTTTAAAGCCACAA -> CGTGTTTTAAAGCCACAAC
TCGTTCAATCATTACTGTA -> CGTTCAATCATTACTGTAG
TCTAAACTTTCCACCTAGG -> CTAAACTTTCCACCTAGGG
TCTACGAAGTGGCACCATG -> CTACGAAGTGGCACCATGC
TCTACGCTGATGAATGGCT -> CTACGCTGATGAATGGCTC
TCTAGCATTGTGGACGGCG -> CTAGCATTGTGGACGGCGA
TCTAGCCTCGGTCTGCGTT -> CTAGCCTCGGTCTGCGTTT
TCTCAGAGAGGTGGTGGGG -> CTCAGAGAGGTGGTGGGGC
TCTCATTCTCATTTGCTTT -> CTCATTCTCATTTGCTTTA
TCTCATTTGCTTTACGGCC -> CTCATTTGCTTTACGGCCT
TCTCCAAACCCGCAATTAT -> CTCCAAACCCGCAATTATA
TCTCCGCAAAACTTCAGCC -> CTCCGCAAAACTTCAGCCA
TCTCCTCGGGTATTATCAC -> CTCCTCGGGTATTATCACT
TCTCGAAGGGTTATGGAGA -> CTCGAAGGGTTATGGAGAA
TCTCGAGGATGCCCTTCAG -> CTCGAGGATGCCCTTCAGC
TCTCGGTTGTGTGCCTCGG -> CTCGGTTGTGTGCCTCGGC
TCTCGTAAGTACAGTTGAT -> CTCGTAAGTACAGTTGATT
TCTCTCTGAATACGTGGAC -> CTCTCTGAATACGTGGACG
TCTCTGAATACGTGGACGA -> CTCTGAATACGTGGACGAT
TCTGAATACGTGGACGATC -> CTGAATACGTGGACGATCG
TCTGCGTGATCAATATCTC -> CTGCGTGATCAATATCTCA
TCTGCGTTTTGCAAAGGGC -> CTGCGTTTTGCAAAGGGCA
TCTGGATAAGACACAAAAT -> CTGGATAAGACACAAAATA
TCTGTCCATCTAGCATTGT -> CTGTCCATCTAGCATTGTG
TCTTAAAACGGTGTGTGAA -> CTTAAAACGGTGTGTGAAA
TCTTAACTTGAAGCGATTT -> CTTAACTTGAAGCGATTTC
TCTTACATAATATGAAGAT -> CTTACATAATATGAAGATC
TCTTAGGAGAGAGGGTTTT -> CTTAGGAGAGAGGGTTTTG
TCTTAGGTGCAGCGACTCG -> CTTAGGTGCAGCGACTCGC
TCTTAGTTCCGTCCGGATC -> CTTAGTTCCGTCCGGATCC
TCTTCGACAACAATGCATT -> CTTCGACAACAATGCATTG
TCTTCTCGAAGGGTTATGG -> CTTCTCGAAGGGTTATGGA
TCTTCTTCGACAACAATGC -> CTTCTTCGACAACAATGCA
TCTTGAATTCGCGAGCTTT -> CTTGAATTCGCGAGCTTTC
TCTTGACGGCCGCGTGAGA -> CTTGACGGCCGCGTGAGAG
TCTTGGCTGAATACGAGAT -> CTTGGCTGAATACGAGATA
TCTTGTACGATAGCAGGTC -> CTTGTACGATAGCAGGTCG
TGAAAAGTCCCATACTGGT -> GAAAAGTCCCATACTGGTG
TGAAACCCCACGGAAGGGG -> GAAACCCCACGGAAGGGGT
TGAACGCGCCCATTTCTTA -> GAACGCGCCCATTTCTTAG
TGAAGATCGAATAGAAACG -> GAAGATCGAATAGAAACGT
TGAAGCGATTTCATGCTCG -> GAAGCGATTTCATGCTCGG
TGAATACCGGAATTACTTC -> GAATACCGGAATTACTTCA
TGAATACGAGATATTACTC -> GAATACGAGATATTACTCC
TGAATACGTGGACGATCGA -> GAATACGTGGACGATCGAT
TGAATGGCTCAAATCGATA -> GAATGGCTCAAATCGATAA
TGAATTCGCGAGCTTTCTA -> GAATTCGCGAGCTTTCTAC
TGACATTGACCCCACGCGA -> GACATTGACCCCACGCGAT
TGACCCCACGCGATCGTCT -> GACCCCACGCGATCGTCTT
TGACCGAGATGAGTACCAG -> GACCGAGATGAGTACCAGT
TGACCTCTACGAAGTGGCA -> GACCTCTACGAAGTGGCAC
TGACGAATATCAACACAGA -> GACGAATATCAACACAGAA
TGACGGCCGCGTGAGAGCA -> GACGGCCGCGTGAGAGCAG
TGAGAGCAGCGGTGGAACA -> GAGAGCAGCGGTGGAACAT
TGAGCAAAAACCTCGTTCA -> GAGCAAAAACCTCGTTCAA
TGAGCGGCGGTACGAGGGT -> GAGCGGCGGTACGAGGGTC
TGAGGTCCGTCATATTAAG -> GAGGTCCGTCATATTAAGA
TGAGTACACTGGTTACATA -> GAGTACACTGGTTACATAT
TGAGTACCAGTAGCATATT -> GAGTACCAGTAGCATATTC
TGAGTGGCATCACGTAGTT -> GAGTGGCATCACGTAGTTC
TGAGTTCTTACATAATATG -> GAGTTCTTACATAATATGA
TGATATTGTTCCTCGTCGG -> GATATTGTTCCTCGTCGGA
TGATCAATATCTCAGAGAG -> GATCAATATCTCAGAGAGG
TGATCTCCAAACCCGCAAT -> GATCTCCAAACCCGCAATT
TGATCTTGGCTGAATACGA -> GATCTTGGCTGAATACGAG
TGATGAATGGCTCAAATCG -> GATGAATGGCTCAAATCGA
TGATGGTCCCTGTGTGCCT -> GATGGTCCCTGTGTGCCTC
TGATTAGTTACACAACCAG -> GATTAGTTACACAACCAGC
TGATTCAATCTTAGGTGCA -> GATTCAATCTTAGGTGCAG
TGATTTTGCGGTGAACGCG -> GATTTTGCGGTGAACGCGC
TGCAAACGAGGGAATGCTG -> GCAAACGAGGGAATGCTGC
TGCAAAGGGCACACCTAAC -> GCAAAGGGCACACCTAACC
TGCAAATTTTGCCTCGCGT -> GCAAATTTTGCCTCGCGTA
TGCACAGGGCCCGCTAAAA -> GCACAGGGCCCGCTAAAAT
TGCACCGACGTGTGAATAC -> GCACCGACGTGTGAATACC
TGCACGGCGTTGAACTTCC -> GCACGGCGTTGAACTTCCG
TGCACTACTTTCGATCCAT -> GCACTACTTTCGATCCATC
TGCAGCGACTCGCAGTACT -> GCAGCGACTCGCAGTACTC
TGCAGTGTAATCAGATATA -> GCAGTGTAATCAGATATAC
TGCATTGTCTTCTCGAAGG -> GCATTGTCTTCTCGAAGGG
TGCCAAGGAGAATACATAG -> GCCAAGGAGAATACATAGT
TGCCACGGGACAAACACCA -> GCCACGGGACAAACACCAA
TGCCCTTCAGCTCAGACAG -> GCCCTTCAGCTCAGACAGT
TGCCTCGCGTATAGGTGGG -> GCCTCGCGTATAGGTGGGT
TGCCTCGGCACAGACCGAT -> GCCTCGGCACAGACCGATA
TGCCTCGGCACAGACCGGA -> GCCTCGGCACAGACCGGAT
TGCCTCGGCACAGACGCAG -> GCCTCGGCACAGACGCAGG
TGCCTCGGCACAGACTCTC -> GCCTCGGCACAGACTCTCA
TGCCTGTTCCACGAGAGAA -> GCCTGTTCCACGAGAGAAA
TGCGACCTGTGTAACCGTG -> GCGACCTGTGTAACCGTGC
TGCGAGAGGTCACAGTGAT -> GCGAGAGGTCACAGTGATT
TGCGAGCTGGTATAATTGA -> GCGAGCTGGTATAATTGAT
TGCGGTGAACGCGCCCATT -> GCGGTGAACGCGCCCATTT
TGCGTGATCAATATCTCAG -> GCGTGATCAATATCTCAGA
TGCGTTTTGCAAAGGGCAC -> GCGTTTTGCAAAGGGCACA
TGCTAAAAAGCAGTTTGGG -> GCTAAAAAGCAGTTTGGGG
TGCTAAGTCGATCGAGTGC -> GCTAAGTCGATCGAGTGCG
TGCTCCCAGCAGCAAGGAC -> GCTCCCAGCAGCAAGGACT
TGCTCGGACTCACAGCCAT -> GCTCGGACTCACAGCCATA
TGCTGCTCCCAGCAGCAAG -> GCTGCTCCCAGCAGCAAGG
TGCTTCTAGCCTCGGTCTG -> GCTTCTAGCCTCGGTCTGC
TGCTTTACGGCCTGACCTC -> GCTTTACGGCCTGACCTCT
TGGAACAGGTTCGCGATAG -> GGAACAGGTTCGCGATAGA
TGGAACATGTCTGGATAAG -> GGAACATGTCTGGATAAGA
TGGACGATCGATCTCCTCG -> GGACGATCGATCTCCTCGG
TGGACGATTGATTTTGCGG -> GGACGATTGATTTTGCGGT
TGGACGGCGAGTGTACTAC -> GGACGGCGAGTGTACTACG
TGGAGAAAGTGCCTGTTCC -> GGAGAAAGTGCCTGTTCCA
TGGATAAGACACAAAATAA -> GGATAAGACACAAAATAAT
TGGCACCATGCACCGACGT -> GGCACCATGCACCGACGTG
TGGCACGAGCCCAAGGAGC -> GGCACGAGCCCAAGGAGCC
TGGCATCACGTAGTTCCGT -> GGCATCACGTAGTTCCGTC
TGGCCAGACTGCTTCTAGC -> GGCCAGACTGCTTCTAGCC
TGGCGGACATAGCCACCCA -> GGCGGACATAGCCACCCAA
TGGCTCAAATCGATAAGAG -> GGCTCAAATCGATAAGAGA
TGGCTCGTGTTTTAAAGCC -> GGCTCGTGTTTTAAAGCCA
TGGCTGAATACGAGATATT -> GGCTGAATACGAGATATTA
TGGCTTGACCGAGATGAGT -> GGCTTGACCGAGATGAGTA
TGGGCATTACAGGTTGGCT -> GGGCATTACAGGTTGGCTT
TGGGCGGGAGCTTATCATG -> GGGCGGGAGCTTATCATGA
TGGGCGTCTTGACGGCCGC -> GGGCGTCTTGACGGCCGCG
TGGGCTGCTAAGTCGATCG -> GGGCTGCTAAGTCGATCGA
TGGGCTGTACTCCATTGAG -> GGGCTGTACTCCATTGAGC
TGGGGATTTGCAAACGAGG -> GGGGATTTGCAAACGAGGG
TGGGGCCCCGAACTTTTGT -> GGGGCCCCGAACTTTTGTG
TGGGGTCGCCGCCCTGTAA -> GGGGTCGCCGCCCTGTAAT
TGGGGTGGGCATTACAGGT -> GGGGTGGGCATTACAGGTT
TGGGTAAGCAGGTCTTCTT -> GGGTAAGCAGGTCTTCTTC
TGGTATAATTGATCTTGGC -> GGTATAATTGATCTTGGCT
TGGTCCCTGTGTGCCTCGG -> GGTCCCTGTGTGCCTCGGC
TGGTGGAACAGGTTCGCGA -> GGTGGAACAGGTTCGCGAT
TGGTGGGGCCCCGAACTTT -> GGTGGGGCCCCGAACTTTT
TGGTGTTGTGTGCCTCGGC -> GGTGTTGTGTGCCTCGGCA
TGGTTACATATCACCCATC -> GGTTACATATCACCCATCA
TGGTTCTCTCTGAATACGT -> GGTTCTCTCTGAATACGTG
TGGTTGCACAGGGCCCGCT -> GGTTGCACAGGGCCCGCTA
TGTAAATTCCCGGAGCACC -> GTAAATTCCCGGAGCACCC
TGTAACCGTGCACTACTTT -> GTAACCGTGCACTACTTTC
TGTAATAGTGACGAATATC -> GTAATAGTGACGAATATCA
TGTAATCAGATATACTTGC -> GTAATCAGATATACTTGCA
TGTACGATAGCAGGTCGAT -> GTACGATAGCAGGTCGATG
TGTACTACGGGAAGTACGT -> GTACTACGGGAAGTACGTA
TGTACTAGTTCCGTCCGGA -> GTACTAGTTCCGTCCGGAT
TGTACTCCATTGAGCAAAA -> GTACTCCATTGAGCAAAAA
TGTAGAGGATGATATTGTT -> GTAGAGGATGATATTGTTC
TGTAGTAAGTGCGAGAGGT -> GTAGTAAGTGCGAGAGGTC
TGTAGTGCGACCTGTGTAA -> GTAGTGCGACCTGTGTAAC
TGTATTCATTCGCGCCTAA -> GTATTCATTCGCGCCTAAA
TGTCCATCTAGCATTGTGG -> GTCCATCTAGCATTGTGGA
TGTCTCGTAAGTACAGTTG -> GTCTCGTAAGTACAGTTGA
TGTCTGGATAAGACACAAA -> GTCTGGATAAGACACAAAA
TGTCTGTCCATCTAGCATT -> GTCTGTCCATCTAGCATTG
TGTCTTCTCGAAGGGTTAT -> GTCTTCTCGAAGGGTTATG
TGTCTTGTACGATAGCAGG -> GTCTTGTACGATAGCAGGT
TGTGAAAAGTCCCATACTG -> GTGAAAAGTCCCATACTGG
TGTGAATACCGGAATTACT -> GTGAATACCGGAATTACTT
TGTGAGTTCTTACATAATA -> GTGAGTTCTTACATAATAT
TGTGCCTCGGCACAGACCG -> GTGCCTCGGCACAGACCGG, GTGCCTCGGCACAGACCGA
TGTGCCTCGGCACAGACGC -> GTGCCTCGGCACAGACGCA
TGTGCCTCGGCACAGACTC -> GTGCCTCGGCACAGACTCT
TGTGGACGATTGATTTTGC -> GTGGACGATTGATTTTGCG
TGTGGACGGCGAGTGTACT -> GTGGACGGCGAGTGTACTA
TGTGTAACCGTGCACTACT -> GTGTAACCGTGCACTACTT
TGTGTAGTGCGACCTGTGT -> GTGTAGTGCGACCTGTGTA
TGTGTGAAAAGTCCCATAC -> GTGTGAAAAGTCCCATACT
TGTGTGCCTCGGCACAGAC -> GTGTGCCTCGGCACAGACT, GTGTGCCTCGGCACAGACC, GTGTGCCTCGGCACAGACC, GTGTGCCTCGGCACAGACG
TGTGTTAGCGAGTAATCCC -> GTGTTAGCGAGTAATCCCC
TGTTAGCGAGTAATCCCCT -> GTTAGCGAGTAATCCCCTA
TGTTCCACGAGAGAAATAC -> GTTCCACGAGAGAAATACC
TGTTCCTCGTCGGACCCCG -> GTTCCTCGTCGGACCCCGA
TGTTCTCGAGGATGCCCTT -> GTTCTCGAGGATGCCCTTC
TGTTGCAGTGTAATCAGAT -> GTTGCAGTGTAATCAGATA
TGTTGTGTGCCTCGGCACA -> GTTGTGTGCCTCGGCACAG
TGTTTGTAAATTCCCGGAG -> GTTTGTAAATTCCCGGAGC
TGTTTTAAAGCCACAACTT -> GTTTTAAAGCCACAACTTT
TTAAAACGGTGTGTGAAAA -> TAAAACGGTGTGTGAAAAG
TTAAAGCCACAACTTTGGG -> TAAAGCCACAACTTTGGGG
TTAACTTGAAGCGATTTCA -> TAACTTGAAGCGATTTCAT
TTAAGAGAGCGTCCACCCC -> TAAGAGAGCGTCCACCCCT
TTAATGAGGTCCGTCATAT -> TAATGAGGTCCGTCATATT
TTACACAACCAGCCTACTC -> TACACAACCAGCCTACTCC
TTACAGGTTGGCTTGACCG -> TACAGGTTGGCTTGACCGA
TTACATAATATGAAGATCG -> TACATAATATGAAGATCGA
TTACATATCACCCATCAAT -> TACATATCACCCATCAATT
TTACGGCCTGACCTCTACG -> TACGGCCTGACCTCTACGA
TTACTAGAAGCTACCTTAT -> TACTAGAAGCTACCTTATG
TTACTCCCTACATCTTGAA -> TACTCCCTACATCTTGAAT
TTACTGCTAAAAAGCAGTT -> TACTGCTAAAAAGCAGTTT
TTACTGTAGAGGATGATAT -> TACTGTAGAGGATGATATT
TTACTTCAACCGTAGCGCA -> TACTTCAACCGTAGCGCAT
TTAGCCTAGCCATAATCGA -> TAGCCTAGCCATAATCGAT
TTAGCGAGTAATCCCCTAG -> TAGCGAGTAATCCCCTAGG
TTAGGAGAGAGGGTTTTGA -> TAGGAGAGAGGGTTTTGAG
TTAGGTGCAGCGACTCGCA -> TAGGTGCAGCGACTCGCAG
TTAGTTACACAACCAGCCT -> TAGTTACACAACCAGCCTA
TTAGTTCCGTCCGGATCCA -> TAGTTCCGTCCGGATCCAT
TTATAGCGGGCGTCCGGGA -> TATAGCGGGCGTCCGGGAA
TTATCACTGTAGTAAGTGC -> TATCACTGTAGTAAGTGCG
TTATCATGAGCGGCGGTAC -> TATCATGAGCGGCGGTACG
TTATCGTGAAACCCCACGG -> TATCGTGAAACCCCACGGA
TTATGATCTCCAAACCCGC -> TATGATCTCCAAACCCGCA
TTATGGAGAAAGTGCCTGT -> TATGGAGAAAGTGCCTGTT
TTATTAGCCTAGCCATAAT -> TATTAGCCTAGCCATAATC
TTATTATTGGCACGAGCCC -> TATTATTGGCACGAGCCCA
TTATTGGCACGAGCCCAAG -> TATTGGCACGAGCCCAAGG
TTCAACCGTAGCGCATGCA -> TCAACCGTAGCGCATGCAA
TTCAATCATTACTGTAGAG -> TCAATCATTACTGTAGAGG
TTCAATCTTAGGTGCAGCG -> TCAATCTTAGGTGCAGCGA
TTCAGCCAGAGCTGGGCGG -> TCAGCCAGAGCTGGGCGGG
TTCAGCTCAGACAGTCGCA -> TCAGCTCAGACAGTCGCAG
TTCATGCTCGGACTCACAG -> TCATGCTCGGACTCACAGC
TTCATTCGCGCCTAAACCG -> TCATTCGCGCCTAAACCGT
TTCCACCTAGGGTACGTCC -> TCCACCTAGGGTACGTCCC
TTCCACGAGAGAAATACCG -> TCCACGAGAGAAATACCGG
TTCCCGCGGAGTGGGCGTC -> TCCCGCGGAGTGGGCGTCT
TTCCCGGAGCACCCATGTA -> TCCCGGAGCACCCATGTAT
TTCCGCCTTCTGCGTGATC -> TCCGCCTTCTGCGTGATCA
TTCCGTCCGGATCCAATTT -> TCCGTCCGGATCCAATTTT
TTCCGTCCGGATCCACCGT -> TCCGTCCGGATCCACCGTA
TTCCGTCCGGATCCAGACT -> TCCGTCCGGATCCAGACTA
TTCCGTCCGGATCCATTGA -> TCCGTCCGGATCCATTGAT
TTCCTCGTCGGACCCCGAC -> TCCTCGTCGGACCCCGACG
TTCGACAACAATGCATTGT -> TCGACAACAATGCATTGTC
TTCGATCCATCATATAAAG -> TCGATCCATCATATAAAGG
TTCGATGGGCTGCTAAGTC -> TCGATGGGCTGCTAAGTCG
TTCGCGAGCTTTCTACGCT -> TCGCGAGCTTTCTACGCTG
TTCGCGATAGACCATGGCC -> TCGCGATAGACCATGGCCA
TTCGCGCCTAAACCGTCGG -> TCGCGCCTAAACCGTCGGG
TTCTAAACTTTCCACCTAG -> TCTAAACTTTCCACCTAGG
TTCTACGCTGATGAATGGC -> TCTACGCTGATGAATGGCT
TTCTAGCCTCGGTCTGCGT -> TCTAGCCTCGGTCTGCGTT
TTCTCATTTGCTTTACGGC -> TCTCATTTGCTTTACGGCC
TTCTCGAAGGGTTATGGAG -> TCTCGAAGGGTTATGGAGA
TTCTCGAGGATGCCCTTCA -> TCTCGAGGATGCCCTTCAG
TTCTCGGTTGTGTGCCTCG -> TCTCGGTTGTGTGCCTCGG
TTCTCTCTGAATACGTGGA -> TCTCTCTGAATACGTGGAC
TTCTGCGTGATCAATATCT -> TCTGCGTGATCAATATCTC
TTCTTAACTTGAAGCGATT -> TCTTAACTTGAAGCGATTT
TTCTTACATAATATGAAGA -> TCTTACATAATATGAAGAT
TTCTTAGGAGAGAGGGTTT -> TCTTAGGAGAGAGGGTTTT
TTCTTCGACAACAATGCAT -> TCTTCGACAACAATGCATT
TTGAAGCGATTTCATGCTC -> TGAAGCGATTTCATGCTCG
TTGAATTCGCGAGCTTTCT -> TGAATTCGCGAGCTTTCTA
TTGACCCCACGCGATCGTC -> TGACCCCACGCGATCGTCT
TTGACCGAGATGAGTACCA -> TGACCGAGATGAGTACCAG
TTGACGGCCGCGTGAGAGC -> TGACGGCCGCGTGAGAGCA
TTGAGCAAAAACCTCGTTC -> TGAGCAAAAACCTCGTTCA
TTGAGTACACTGGTTACAT -> TGAGTACACTGGTTACATA
TTGATCTTGGCTGAATACG -> TGATCTTGGCTGAATACGA
TTGATGGTCCCTGTGTGCC -> TGATGGTCCCTGTGTGCCT
TTGATTCAATCTTAGGTGC -> TGATTCAATCTTAGGTGCA
TTGATTTTGCGGTGAACGC -> TGATTTTGCGGTGAACGCG
TTGCAAACGAGGGAATGCT -> TGCAAACGAGGGAATGCTG
TTGCAAAGGGCACACCTAA -> TGCAAAGGGCACACCTAAC
TTGCACAGGGCCCGCTAAA -> TGCACAGGGCCCGCTAAAA
TTGCACGGCGTTGAACTTC -> TGCACGGCGTTGAACTTCC
TTGCAGTGTAATCAGATAT -> TGCAGTGTAATCAGATATA
TTGCCTCGCGTATAGGTGG -> TGCCTCGCGTATAGGTGGG
TTGCGGTGAACGCGCCCAT -> TGCGGTGAACGCGCCCATT
TTGCTTTACGGCCTGACCT -> TGCTTTACGGCCTGACCTC
TTGGCACGAGCCCAAGGAG -> TGGCACGAGCCCAAGGAGC
TTGGCTGAATACGAGATAT -> TGGCTGAATACGAGATATT
TTGGCTTGACCGAGATGAG -> TGGCTTGACCGAGATGAGT
TTGGGGATTTGCAAACGAG -> TGGGGATTTGCAAACGAGG
TTGGGGTGGGCATTACAGG -> TGGGGTGGGCATTACAGGT
TTGTAAATTCCCGGAGCAC -> TGTAAATTCCCGGAGCACC
TTGTACGATAGCAGGTCGA -> TGTACGATAGCAGGTCGAT
TTGTCTTCTCGAAGGGTTA -> TGTCTTCTCGAAGGGTTAT
TTGTGGACGGCGAGTGTAC -> TGTGGACGGCGAGTGTACT
TTGTGTGCCTCGGCACAGA -> TGTGTGCCTCGGCACAGAC, TGTGTGCCTCGGCACAGAC
TTGTGTTAGCGAGTAATCC -> TGTGTTAGCGAGTAATCCC
TTGTTCCTCGTCGGACCCC -> TGTTCCTCGTCGGACCCCG
TTGTTGCAGTGTAATCAGA -> TGTTGCAGTGTAATCAGAT
TTTAAAGCCACAACTTTGG -> TTAAAGCCACAACTTTGGG
TTTACGGCCTGACCTCTAC -> TTACGGCCTGACCTCTACG
TTTACTGCTAAAAAGCAGT -> TTACTGCTAAAAAGCAGTT
TTTCATGCTCGGACTCACA -> TTCATGCTCGGACTCACAG
TTTCCACCTAGGGTACGTC -> TTCCACCTAGGGTACGTCC
TTTCGATCCATCATATAAA -> TTCGATCCATCATATAAAG
TTTCGATGGGCTGCTAAGT -> TTCGATGGGCTGCTAAGTC
TTTCTACGCTGATGAATGG -> TTCTACGCTGATGAATGGC
TTTCTCGGTTGTGTGCCTC -> TTCTCGGTTGTGTGCCTCG
TTTCTTAGGAGAGAGGGTT -> TTCTTAGGAGAGAGGGTTT
TTTGAGTACACTGGTTACA -> TTGAGTACACTGGTTACAT
TTTGCAAACGAGGGAATGC -> TTGCAAACGAGGGAATGCT
TTTGCAAAGGGCACACCTA -> TTGCAAAGGGCACACCTAA
TTTGCCTCGCGTATAGGTG -> TTGCCTCGCGTATAGGTGG
TTTGCGGTGAACGCGCCCA -> TTGCGGTGAACGCGCCCAT
TTTGCTTTACGGCCTGACC -> TTGCTTTACGGCCTGACCT
TTTGGGGATTTGCAAACGA -> TTGGGGATTTGCAAACGAG
TTTGGGGTGGGCATTACAG -> TTGGGGTGGGCATTACAGG
TTTGTAAATTCCCGGAGCA -> TTGTAAATTCCCGGAGCAC
TTTGTGTTAGCGAGTAATC -> TTGTGTTAGCGAGTAATCC
TTTGTTGCAGTGTAATCAG -> TTGTTGCAGTGTAATCAGA
TTTTAAAGCCACAACTTTG -> TTTAAAGCCACAACTTTGG
TTTTCTCGGTTGTGTGCCT -> TTTCTCGGTTGTGTGCCTC
TTTTGAGTACACTGGTTAC -> TTTGAGTACACTGGTTACA
TTTTGCAAAGGGCACACCT -> TTTGCAAAGGGCACACCTA
TTTTGCCTCGCGTATAGGT -> TTTGCCTCGCGTATAGGTG
TTTTGCGGTGAACGCGCCC -> TTTGCGGTGAACGCGCCCA
TTTTGTGTTAGCGAGTAAT -> TTTGTGTTAGCGAGTAATC
